cvc	cc
mőrügüléjelik	mőrügüléjlik
dokumolik	dokumlik
nokolik	noklik
biszolik	biszlik
vógorik	vógrik
kúlivútolik	kúlivútlik
gőrezik	gőrzik
míjozik	míjzik
zálakolik	zálaklik
pűlekedik	pűlekszik
lokolik	loklik
fizborozik	fizborzik
vőkepedik	vőkepszik
vűrödik	vűrdik
devikedik	devikszik
mökedik	mökszik
fikagolik	fikaglik
zesziséngyőkezik	zesziséngyőkszik
rűzdüjelik	rűzdüjlik
podamolik	podamlik
tíndakozik	tíndakzik
púkolik	púklik
jópuguszolik	jópuguszlik
bápakozik	bápakzik
kijunyozik	kijunyzik
purukászolik	purukászlik
fágínyozik	fágínyzik
röremölik	röremlik
lonorozik	lonorzik
dívokolik	dívoklik
kokamozik	kokamzik
rükökedik	rükökszik
bükedik	bükszik
lözelik	lözlik
kíkomákolik	kíkomáklik
zínyojolik	zínyojlik
kúmolik	kúmlik
lagodik	lagszik
vurolik	vurlik
vúrozubozik	vúrozubzik
jírvajamolik	jírvajamlik
sűsökölik	sűsöklik
bríkedik	bríkdik
lóduragolik	lóduraglik
fultamolik	fultamlik
spínvusmákolik	spínvusmáklik
szüküdik	szükszik
fúgorik	fúgrik
múrajozik	múrajzik
lüsövikikedik	lüsövikikszik
kúkurozik	kúkurzik
bikedik	bikdik
sólorozik	sólorzik
dólikozik	dólikzik
gágyokolik	gágyoklik
vúzusztúnozik	vúzusztúnzik
máturozik	máturzik
jüzelik	jüzlik
línyozik	línyzik
vinigyurozik	vinigyurzik
kilöngekedik	kilöngekszik
kúgogudik	kúgogszik
szézleklűkezik	szézleklűkszik
jákolik	jáklik
béküszik	békszik
sökezik	sökszik
kőnükedik	kőnükdik
ridüküszik	ridükszik
zangakolik	zangaklik
raratámutolik	raratámutlik
büsüzőfűmölik	büsüzőfűmlik
bőfekékedik	bőfekékszik
söjközgűrülik	söjközgűrlik
rőkekörgükezik	rőkekörgükszik
szeselik	szeslik
saridámolik	saridámlik
főrekedik	főrekszik
ládíkodik	ládíkszik
rókijúfokolik	rókijúfoklik
zótoronyozik	zótoronyzik
véjelik	véjlik
bóbozik	bóbzik
girozik	girzik
lédekedik	lédekszik
rűkedik	rűkszik
timogolik	timoglik
pigaludik	pigalszik
mévíbűmörödik	mévíbűmördik
bógokodik	bógokszik
mümlörinölik	mümlörinlik
vógaszolik	vógaszlik
fóvokuzákolik	fóvokuzáklik
dödíröpedik	dödíröpszik
füsekölik	füseklik
kónyínyozik	kónyínyzik
sekönyelik	sekönylik
vobugozik	vobugzik
dénölik	dénlik
pójorozik	pójorzik
rászokozik	rászokzik
madulúkodik	madulúkszik
súmomágyumolik	súmomágyumlik
lekekölik	lekeklik
szifükőgekedik	szifükőgekszik
tőgölik	tőglik
küntezelik	küntezlik
rúsodik	rúslik
dúnlanulik	dúnlanlik
kamolik	kamlik
féndeküdik	féndekszik
budorozik	budorzik
grúvugolik	grúvuglik
kőszörelik	kőszörlik
rimuszumógozik	rimuszumógzik
kégükedik	kégükszik
kúgíkítolik	kúgíkítlik
fóvínozik	fóvínzik
bükedik	bükszik
fépürelik	fépürlik
kófurozik	kófurzik
bőkürözik	bőkürzik
büpijelik	büpijlik
vamozik	vamzik
vútolik	vútlik
tamolik	tamlik
nidrasodik	nidraslik
rónyagolik	rónyaglik
füpönölik	füpönlik
vörükedik	vörükszik
strűkedik	strűkdik
fányozik	fányzik
rűderözik	rűderzik
püzgövüvízelik	püzgövüvízlik
löderezik	löderzik
mőrelik	mőrlik
tirozik	tirzik
gígozik	gígzik
trilakabujolik	trilakabujlik
fáginúnvúrozik	fáginúnvúrzik
mődölik	mődlik
nönölik	nönlik
tíszílűrözik	tíszílűrzik
rűlrírezik	rűlrírzik
rökírgétűnölik	rökírgétűnlik
kázsusodik	kázsuslik
fűkeselik	fűkeslik
téntönyelik	téntönylik
vímolik	vímlik
kogagozik	kogagzik
roszujozik	roszujzik
nunamolik	nunamlik
vávumolik	vávumlik
tószolik	tószlik
sóbígodik	sóbígszik
kójozik	kójzik
tuzakolik	tuzaklik
rarbilagorik	rarbilagrik
púlusodik	púluslik
szurtamúsodik	szurtamúslik
furgidágodik	furgidágszik
kúzijolik	kúzijlik
pőkedik	pőkszik
kegölik	keglik
röntökedik	röntökszik
néntömelik	néntömlik
mabimolik	mabimlik
dökedik	dökszik
tugozik	tugzik
séküszik	sékszik
nígurozik	nígurzik
vógolik	vóglik
taklusodik	takluslik
kodígozik	kodígzik
pimökölik	pimöklik
tamintrituszolik	tamintrituszlik
tigzutagolik	tigzutaglik
fúmolik	fúmlik
kászunulik	kászunlik
lübökezik	lübökszik
szurikumolik	szurikumlik
ninyozik	ninyzik
kúrzutkukírozik	kúrzutkukírzik
girzanogdapodik	girzanogdapszik
terörezik	terörzik
dépísűkedik	dépísűkszik
kúbrígozik	kúbrígzik
pújtapagolik	pújtapaglik
fütökezik	fütökszik
bekölik	beklik
tüközölik	tüközlik
tázasósodik	tázasóslik
sőnyökedik	sőnyökszik
bovomolik	bovomlik
togirozik	togirzik
pügezik	pügzik
vúmolik	vúmlik
zsiloszogozik	zsiloszogzik
tómolómolik	tómolómlik
rigupodik	rigupszik
tragodik	tragszik
töjelik	töjlik
furígozik	furígzik
vópíkolik	vópíklik
büvípedik	büvípszik
flákarozik	flákarzik
lúrozik	lúrzik
szazugorik	szazugrik
bénögedik	bénögszik
bószotyukogolik	bószotyukoglik
líszalomolik	líszalomlik
tégölik	téglik
kűküszik	kűkszik
kürözik	kürzik
vorítolik	vorítlik
muzsagolik	muzsaglik
kűszöszérezik	kűszöszérzik
förörezik	förörzik
kupotolik	kupotlik
fűregyzívőgelik	fűregyzívőglik
lorimozik	lorimzik
rékezik	rékszik
bóbozik	bóbzik
szűgyörezik	szűgyörzik
tüselik	tüslik
bímigozik	bímigzik
vábodujozik	vábodujzik
rütigyűvijelik	rütigyűvijlik
tönölőkedik	tönölőkszik
lószolik	lószlik
jibatolik	jibatlik
köküszik	kökszik
búzgírákodik	búzgírákszik
vokimolik	vokimlik
báztíjozik	báztíjzik
virdamozik	virdamzik
fotkígokolik	fotkígoklik
lovazsagazik	lovazsagzik
tászolik	tászlik
kiguvabótolik	kiguvabótlik
mővekölik	mőveklik
tozsolik	tozslik
lamolik	lamlik
tizímolik	tizímlik
frájolik	frájlik
nimölik	nimlik
tipodik	tipdik
tómolik	tómlik
bazgímúsímolik	bazgímúsímlik
gígedik	gígszik
krúsatolik	krúsatlik
gármajozik	gármajzik
todísodik	todíslik
szunulik	szunlik
silagudik	silagszik
vósodik	vóslik
ribíjelik	ribíjlik
ritolik	ritlik
kigudik	kigszik
fökölik	föklik
söküdik	sökszik
fűgekedik	fűgekszik
vutogomolik	vutogomlik
bugíkolik	bugíklik
kiromolik	kiromlik
rógozik	rógzik
túpokozik	túpokzik
gíkedik	gíkdik
bákolik	báklik
tingovájozik	tingovájzik
tivagozik	tivagzik
szumolik	szumlik
fősüszíkedik	fősüszíkdik
fápagolik	fápaglik
súvarbóbujozik	súvarbóbujzik
kúmigozik	kúmigzik
kirozik	kirzik
sugikodik	sugikszik
vudírozik	vudírzik
kőfekedik	kőfekszik
runjuzsolik	runjuzslik
kodurozik	kodurzik
kósalópodik	kósalópszik
lőpedik	lőpszik
júvíntagozik	júvíntagzik
mönyelik	mönylik
szökedik	szökszik
zókagozik	zókagzik
lölegedik	lölegszik
vünyelik	vünylik
gómolik	gómlik
gugozik	gugzik
kímolik	kímlik
fúpumúgozik	fúpumúgzik
konugudik	konugszik
róbikolik	róbiklik
dükükezik	dükükszik
dígajrógolik	dígajróglik
nabokolik	naboklik
subonozik	subonzik
gúdiszójolik	gúdiszójlik
pímbogozik	pímbogzik
míktügelik	míktüglik
tókolik	tóklik
tóguszik	tógszik
dosugútolik	dosugútlik
mépökezik	mépökszik
póskuludik	póskulszik
pamolik	pamlik
fópugolik	fópuglik
vupodik	vupszik
tirönűkezik	tirönűkszik
toduszolik	toduszlik
fólaluszik	fólalszik
pákokozik	pákokzik
szásokolik	szásoklik
kóbogozik	kóbogzik
sűkezik	sűkszik
szogozik	szogzik
fílmonulik	fílmonlik
béjelik	béjlik
muguvikodik	muguvikszik
káskogorik	káskogrik
vőpedik	vőpszik
jójozik	jójzik
kűkedik	kűkszik
pafugudik	pafugszik
fudorkúkolik	fudorkúklik
fézünyelik	fézünylik
búkozik	búkzik
kepígezik	kepígzik
dibumolik	dibumlik
kumolik	kumlik
dakukodik	dakukszik
kolagozik	kolagzik
murkugozik	murkugzik
kontakolik	kontaklik
bóbímolik	bóbímlik
lozkogolik	lozkoglik
tímolik	tímlik
lópimolik	lópimlik
dúgudik	dúgszik
prerözik	prerzik
fóptirozik	fóptirzik
rokokodik	rokokszik
fanigtálíkolik	fanigtálíklik
fókolik	fóklik
zűpilmöténölik	zűpilmöténlik
turkafántrábozik	turkafántrábzik
púfogolik	púfoglik
konozik	konzik
terödik	terdik
zúnozik	zúnzik
dikezik	dikszik
liskügezik	liskügzik
víkugozik	víkugzik
gibekedik	gibekszik
damolik	damlik
tironulik	tironlik
dralogorik	dralogrik
pűnyígedik	pűnyígszik
kepünlídékedik	kepünlídékdik
rásumúkozik	rásumúkzik
skuszurozik	skuszurzik
sugozik	sugzik
dévüszlűgedik	dévüszlűgszik
kőmözénölik	kőmözénlik
zúrkagozik	zúrkagzik
szűpegedik	szűpegdik
logyumolik	logyumlik
főgelik	főglik
pospinozik	pospinzik
frégezik	frégzik
pumolik	pumlik
giríjozik	giríjzik
tráramolik	tráramlik
vőnyelik	vőnylik
vógolik	vóglik
rúrínyozik	rúrínyzik
röserözik	röserzik
szurjakorigolik	szurjakoriglik
bukakolik	bukaklik
sekímölik	sekímlik
tigelik	tiglik
bóvagyafájozik	bóvagyafájzik
púlpukolik	púlpuklik
szugorik	szugrik
danulik	danlik
vírejtőzelik	vírejtőzlik
sökötűgedik	sökötűgszik
vúrkukolik	vúrkuklik
kőkedik	kőkszik
roluszik	rolszik
kolapodik	kolapszik
kűngesüjelik	kűngesüjlik
böbezelik	böbezlik
fálukolik	fáluklik
júlvagorik	júlvagrik
fákímolik	fákímlik
szazarozik	szazarzik
fózíszolik	fózíszlik
rígolik	ríglik
zógozik	zógzik
rudragozik	rudragzik
sígorik	sígrik
múzsolik	múzslik
poszokozik	poszokzik
vónyotolik	vónyotlik
bígolik	bíglik
pímligedik	pímligszik
lumopodik	lumopdik
kőkerezik	kőkerzik
vírakolik	víraklik
túkolik	túklik
tádoluszolik	tádoluszlik
vőtíkedik	vőtíkdik
vúrgogodik	vúrgogszik
kőngíkükedik	kőngíkükdik
szulotlógozik	szulotlógzik
mótanyozik	mótanyzik
rópamolik	rópamlik
bofagozik	bofagzik
sűgedik	sűgszik
búkolik	búklik
mómolik	mómlik
dotikozik	dotikzik
fupodik	fupdik
röselik	röslik
fükíbügezik	fükíbügzik
devükedik	devükdik
küpedik	küpszik
vogakozik	vogakzik
rűzígezik	rűzígzik
könyelik	könylik
rúbozik	rúbzik
szusologozik	szusologzik
szávinkógozik	szávinkógzik
kógagozik	kógagzik
vúrakakitolik	vúrakakitlik
súnulik	súnlik
sükögedik	sükögdik
müpínyőkelik	müpínyőklik
kíszogozik	kíszogzik
vúsugodik	vúsugszik
stabupúmolik	stabupúmlik
lőnyelik	lőnylik
muvutolik	muvutlik
búzitszósodik	búzitszóslik
katurozik	katurzik
pinamolik	pinamlik
dasigodik	dasigszik
lüngezörezik	lüngezörzik
túdagozik	túdagzik
dílunyozik	dílunyzik
múgyaszóbínyozik	múgyaszóbínyzik
rókolik	róklik
dünyelik	dünylik
lósíkolik	lósíklik
kegölik	keglik
szürözik	szürzik
vigazározik	vigazárzik
dólaragolik	dólaraglik
szudarozik	szudarzik
bígudik	bígszik
nórvítigukolik	nórvítiguklik
sézüregezik	sézüregzik
vőkölik	vőklik
dáfabozik	dáfabzik
dijlizsolik	dijlizslik
pekedölik	pekedlik
fébekedik	fébekszik
rúlígodik	rúlígszik
sugozik	sugzik
dezelik	dezlik
szadaszolik	szadaszlik
gógazik	gógzik
tipugolik	tipuglik
vískagolik	vískaglik
natirozik	natirzik
tőzelik	tőzlik
szimolik	szimlik
réfökezik	réfökszik
kirízázákodik	kirízázákszik
bostijozik	bostijzik
zűkiselik	zűkislik
rősikölik	rősiklik
venteselik	venteslik
panyigolik	panyiglik
vozsorozik	vozsorzik
mózíszómolik	mózíszómlik
fubígúzsolik	fubígúzslik
bursinyozik	bursinyzik
sízekedik	sízekszik
famolik	famlik
nűküdik	nűkszik
sákodik	sákszik
frónorozik	frónorzik
pireküdik	pirekszik
vógozik	vógzik
tákuszolik	tákuszlik
sűterödik	sűterdik
rogatolik	rogatlik
műpegelik	műpeglik
tíkolik	tíklik
röfökelik	röföklik
káskamkogozik	káskamkogzik
filarozik	filarzik
fákíntijozik	fákíntijzik
nasirolik	nasirlik
küferőgezik	küferőgzik
vörödik	vördik
tavutározik	tavutárzik
rósodik	róslik
víselik	víslik
metepöksöselik	metepöksöslik
mónyudokolik	mónyudoklik
tívikedik	tívikszik
língeküdik	língekszik
rarumolik	rarumlik
szetökezik	szetökszik
prukolik	pruklik
gripumolik	gripumlik
jőzekűrözik	jőzekűrzik
tézügölik	tézüglik
kazogorik	kazogrik
sipszogozik	sipszogzik
rílünölik	rílünlik
tígelik	tíglik
kügelik	küglik
szitörűvűrezik	szitörűvűrzik
fötíkedik	fötíkszik
gúszolik	gúszlik
laraszúmolik	laraszúmlik
szaprujozik	szaprujzik
lerögezik	lerögzik
tamolik	tamlik
berezik	berzik
tafajolik	tafajlik
púsíkozik	púsíkzik
kőrülik	kőrlik
grígölik	gríglik
mípegölik	mípeglik
stragodik	stragszik
szaztigozik	szaztigzik
szünyildirödik	szünyildirdik
mügölik	müglik
polmodúbágolik	polmodúbáglik
bászugorik	bászugrik
fímuturmómolik	fímuturmómlik
kópumolik	kópumlik
tórolik	tórlik
vúfatolik	vúfatlik
risimolik	risimlik
rékedik	rékszik
kagarozik	kagarzik
fózovímolik	fózovímlik
kozolúsodik	kozolúslik
mőrerezik	mőrerzik
sartigozik	sartigzik
kusodik	kuslik
jízigozik	jízigzik
folmumozik	folmumzik
rúnyozik	rúnyzik
nokovógolik	nokovóglik
szötöföszelik	szötöföszlik
redöselik	redöslik
lőrödik	lőrdik
tevijelik	tevijlik
batutolik	batutlik
livígozik	livígzik
fűferkizelik	fűferkizlik
beszíkedik	beszíkdik
buroszátolik	buroszátlik
tizaludik	tizalszik
föveléjőrezik	föveléjőrzik
tradtogozik	tradtogzik
túmolik	túmlik
szokigorik	szokigrik
furozik	furzik
kúgolik	kúglik
mumolik	mumlik
pramamolik	pramamlik
rúpodik	rúpszik
jünyelik	jünylik
főpökedik	főpökszik
fakurozik	fakurzik
vurtigozik	vurtigzik
potamolik	potamlik
vitotúlúmolik	vitotúlúmlik
fázorozik	fázorzik
mánagolik	mánaglik
lumígyajolik	lumígyajlik
lőbejtíkedik	lőbejtíkszik
kirvorozik	kirvorzik
szeskerködőrezik	szeskerködőrzik
kőgedik	kőgdik
túdatolik	túdatlik
düríkezik	düríkszik
sélerödik	sélerdik
tósodik	tóslik
doszígozik	doszígzik
bógyipodik	bógyipszik
gemörükedik	gemörükszik
vúlirozik	vúlirzik
fólitolik	fólitlik
pőgezik	pőgzik
rökölik	röklik
kőjíkípűgölik	kőjíkípűglik
fumbogozik	fumbogzik
tórzsarozik	tórzsarzik
bodígutúnulik	bodígutúnlik
szökezik	szökszik
tizdurozik	tizdurzik
kodarirozik	kodarirzik
vúkolik	vúklik
mulorozik	mulorzik
lofogodik	lofogszik
dézömbűgölik	dézömbűglik
kőgölik	kőglik
muldazsolik	muldazslik
pólukozik	pólukzik
nilszítolik	nilszítlik
tászodíbozik	tászodíbzik
rökezik	rökszik
duskamolik	duskamlik
surzipómolik	surzipómlik
bürenyelik	bürenylik
jáfoludik	jáfolszik
gükedik	gükszik
novogozik	novogzik
kezíkedik	kezíkszik
kamolik	kamlik
fükögölik	füköglik
sófazákíluszik	sófazákílszik
dulívógozik	dulívógzik
kúmíkolik	kúmíklik
tumolik	tumlik
kamolik	kamlik
gimölik	gimlik
vúnkagozik	vúnkagzik
pozgarozik	pozgarzik
tugantásúmolik	tugantásúmlik
mípükedik	mípükszik
vúnyaspúrozik	vúnyaspúrzik
rudokodik	rudokszik
lekölik	leklik
dúkolik	dúklik
tamolik	tamlik
