word	category	variation	szo
tanév	tilt_freq2	hotelban/hotelben	tanév
háttér	tilt_freq2	hotelban/hotelben	háttér
koncert	tilt_freq2	hotelban/hotelben	koncert
projekt	tilt_freq2	hotelban/hotelben	projekt
modell	tilt_freq2	hotelban/hotelben	modell
ßoftver	tilt_freq2	hotelban/hotelben	szoftver
korrekt	tilt_freq2	hotelban/hotelben	korrekt
duett	tilt_freq2	hotelban/hotelben	duett
sláger	tilt_freq2	hotelban/hotelben	sláger
partner	tilt_freq2	hotelban/hotelben	partner
Ωáner	tilt_freq2	hotelban/hotelben	zsáner
bróker	tilt_freq2	hotelban/hotelben	bróker
kvartett	tilt_freq2	hotelban/hotelben	kvartett
hardver	tilt_freq2	hotelban/hotelben	hardver
poßter	tilt_freq2	hotelban/hotelben	poszter
kábel	tilt_freq2	hotelban/hotelben	kábel
tranßfer	tilt_freq2	hotelban/hotelben	transzfer
póker	tilt_freq2	hotelban/hotelben	póker
kráter	tilt_freq2	hotelban/hotelben	kráter
rubel	tilt_freq2	hotelban/hotelben	rubel
dΩungel	tilt_freq2	hotelban/hotelben	dzsungel
konvent	tilt_freq2	hotelban/hotelben	konvent
advent	tilt_freq2	hotelban/hotelben	advent
kókler	tilt_freq2	hotelban/hotelben	kókler
rulett	tilt_freq2	hotelban/hotelben	rulett
moped	tilt_freq2	hotelban/hotelben	moped
roller	tilt_freq2	hotelban/hotelben	roller
púder	tilt_freq2	hotelban/hotelben	púder
amper	tilt_freq2	hotelban/hotelben	amper
raßter	tilt_freq2	hotelban/hotelben	raszter
makett	tilt_freq2	hotelban/hotelben	makett
puffer	tilt_freq2	hotelban/hotelben	puffer
páter	tilt_freq2	hotelban/hotelben	páter
parkett	tilt_freq2	hotelban/hotelben	parkett
hotel	tilt_freq2	hotelban/hotelben	hotel
paßtell	tilt_freq2	hotelban/hotelben	pasztell
fráter	tilt_freq2	hotelban/hotelben	fráter
kartell	tilt_freq2	hotelban/hotelben	kartell
sólet	tilt_freq2	hotelban/hotelben	sólet
bankett	tilt_freq2	hotelban/hotelben	bankett
barter	NA	hotelban/hotelben	barter
láger	NA	hotelban/hotelben	láger
bojler	NA	hotelban/hotelben	bojler
skanzen	NA	hotelban/hotelben	skanzen
mater	NA	hotelban/hotelben	mater
korner	NA	hotelban/hotelben	korner
káder	NA	hotelban/hotelben	káder
stukker	NA	hotelban/hotelben	stukker
Ωakett	NA	hotelban/hotelben	zsakett
falzett	NA	hotelban/hotelben	falzett
pakett	NA	hotelban/hotelben	pakett
bunker	NA	hotelban/hotelben	bunker
motel	NA	hotelban/hotelben	motel
tróger	NA	hotelban/hotelben	tróger
kukker	NA	hotelban/hotelben	kukker
dózer	NA	hotelban/hotelben	dózer
sóder	NA	hotelban/hotelben	sóder
sparhelt	NA	hotelban/hotelben	sparhelt
koffer	NA	hotelban/hotelben	koffer
kóser	NA	hotelban/hotelben	kóser
sparherd	NA	hotelban/hotelben	sparherd
noteß	NA	hotelban/hotelben	notesz
balett	NA	hotelban/hotelben	balett
sparhert	NA	hotelban/hotelben	sparhert
obßcén	NA	hotelban/hotelben	obszcén
krokett	NA	hotelban/hotelben	krokett
sußter	NA	hotelban/hotelben	suszter
ájer	NA	hotelban/hotelben	ájer
rutén	NA	hotelban/hotelben	rutén
karcer	NA	hotelban/hotelben	karcer
fotel	NA	hotelban/hotelben	fotel
farmer	NA	hotelban/hotelben	farmer
stájer	NA	hotelban/hotelben	stájer
panel	NA	hotelban/hotelben	panel
flanel	NA	hotelban/hotelben	flanel
sumer	NA	hotelban/hotelben	sumer
sakter	NA	hotelban/hotelben	sakter
karter	NA	hotelban/hotelben	karter
smasßer	NA	hotelban/hotelben	smasszer
pançer	tilt_freq1	hotelban/hotelben	pancser
oßét	tilt_freq1	hotelban/hotelben	oszét
flaßter	tilt_freq1	hotelban/hotelben	flaszter
kóter	tilt_freq1	hotelban/hotelben	kóter
bakter	tilt_freq1	hotelban/hotelben	bakter
mutter	tilt_freq1	hotelban/hotelben	mutter
bohém	tilt_freq1	hotelban/hotelben	bohém
sameß	tilt_freq1	hotelban/hotelben	samesz
ßlovén	tilt_freq1	hotelban/hotelben	szlovén
arzén	tilt_freq1	hotelban/hotelben	arzén
malter	tilt_freq1	hotelban/hotelben	malter
maceß	tilt_freq1	hotelban/hotelben	macesz
patent	tilt_freq1	hotelban/hotelben	patent
klozet	tilt_freq1	hotelban/hotelben	klozet
muter	tilt_freq1	hotelban/hotelben	muter
krapek	tilt_freq1	hotelban/hotelben	krapek
ßolféΩ	tilt_freq1	hotelban/hotelben	szolfézs
balek	tilt_freq1	hotelban/hotelben	balek
honvéd	tilt_freq1	hotelban/hotelben	honvéd
fater	tilt_freq1	hotelban/hotelben	fater
kadét	tilt_freq1	hotelban/hotelben	kadét
ankét	tilt_freq1	hotelban/hotelben	ankét
norvég	tilt_freq1	hotelban/hotelben	norvég
affér	tilt_freq1	hotelban/hotelben	affér
haver	tilt_freq1	hotelban/hotelben	haver
maßek	tilt_freq1	hotelban/hotelben	maszek
trapéz	tilt_freq1	hotelban/hotelben	trapéz
matek	tilt_freq1	hotelban/hotelben	matek
konkrét	tilt_freq1	hotelban/hotelben	konkrét
koktél	tilt_freq1	hotelban/hotelben	koktél
poén	tilt_freq1	hotelban/hotelben	poén
ár¥ék	tilt_freq1	hotelban/hotelben	árnyék
fazék	tilt_freq1	hotelban/hotelben	fazék
tá¥ér	tilt_freq1	hotelban/hotelben	tányér
húsvét	tilt_freq1	hotelban/hotelben	húsvét
pótlék	tilt_freq1	hotelban/hotelben	pótlék
ßomßéd	tilt_freq1	hotelban/hotelben	szomszéd
kasté¬	tilt_freq1	hotelban/hotelben	kastély
játék	tilt_freq1	hotelban/hotelben	játék
esküßik	tilt_freq2	lakok/lakom	esküszik
törekßik	tilt_freq2	lakok/lakom	törekszik
emlékßik	tilt_freq2	lakok/lakom	emlékszik
öregßik	tilt_freq2	lakok/lakom	öregszik
vadáßik	tilt_freq2	lakok/lakom	vadászik
ßármazik	tilt_freq2	lakok/lakom	származik
i©ekßik	tilt_freq2	lakok/lakom	igyekszik
diçekßik	tilt_freq2	lakok/lakom	dicsekszik
ßűkölködik	tilt_freq2	lakok/lakom	szűkölködik
lakozik	tilt_freq2	lakok/lakom	lakozik
vá©ódik	tilt_freq2	lakok/lakom	vágyódik
©anakßik	tilt_freq2	lakok/lakom	gyanakszik
¥ugßik	tilt_freq2	lakok/lakom	nyugszik
haragßik	tilt_freq2	lakok/lakom	haragszik
elégßik	tilt_freq2	lakok/lakom	elégszik
rendelkezik	tilt_freq2	lakok/lakom	rendelkezik
ßomjazik	tilt_freq2	lakok/lakom	szomjazik
foháßkodik	tilt_freq2	lakok/lakom	fohászkodik
tanúskodik	tilt_freq2	lakok/lakom	tanúskodik
boçátkozik	tilt_freq2	lakok/lakom	bocsátkozik
imádkozik	tilt_freq2	lakok/lakom	imádkozik
vonzódik	tilt_freq2	lakok/lakom	vonzódik
çelekßik	tilt_freq2	lakok/lakom	cselekszik
bátorkodik	tilt_freq2	lakok/lakom	bátorkodik
ßorítkozik	tilt_freq2	lakok/lakom	szorítkozik
tartózkodik	tilt_freq2	lakok/lakom	tartózkodik
verekßik	tilt_freq2	lakok/lakom	verekszik
©ö¥örködik	tilt_freq2	lakok/lakom	gyönyörködik
növekßik	tilt_freq2	lakok/lakom	növekszik
ringatózik	tilt_freq2	lakok/lakom	ringatózik
dohá¥zik	tilt_freq2	lakok/lakom	dohányzik
oßtozik	tilt_freq2	lakok/lakom	osztozik
foglalkozik	tilt_freq2	lakok/lakom	foglalkozik
táplálkozik	tilt_freq2	lakok/lakom	táplálkozik
melegßik	tilt_freq2	lakok/lakom	melegszik
gondoskodik	tilt_freq2	lakok/lakom	gondoskodik
ragaßkodik	tilt_freq2	lakok/lakom	ragaszkodik
látßik	tilt_freq2	lakok/lakom	látszik
bízik	tilt_freq2	lakok/lakom	bízik
irtózik	tilt_freq2	lakok/lakom	irtózik
¥ilatkozik	tilt_freq2	lakok/lakom	nyilatkozik
tűnődik	tilt_freq2	lakok/lakom	tűnődik
çodálkozik	tilt_freq2	lakok/lakom	csodálkozik
létezik	tilt_freq2	lakok/lakom	létezik
munkálkodik	tilt_freq2	lakok/lakom	munkálkodik
©ötrődik	tilt_freq2	lakok/lakom	gyötrődik
fekßik	tilt_freq2	lakok/lakom	fekszik
zongorázik	tilt_freq2	lakok/lakom	zongorázik
idősödik	tilt_freq2	lakok/lakom	idősödik
gondolkodik	tilt_freq2	lakok/lakom	gondolkodik
étkezik	tilt_freq2	lakok/lakom	étkezik
rejtőzködik	tilt_freq2	lakok/lakom	rejtőzködik
betegßik	tilt_freq2	lakok/lakom	betegszik
kezeskedik	tilt_freq2	lakok/lakom	kezeskedik
lakik	tilt_freq2	lakok/lakom	lakik
öltözködik	tilt_freq2	lakok/lakom	öltözködik
veßekßik	tilt_freq2	lakok/lakom	veszekszik
alßik	tilt_freq2	lakok/lakom	alszik
vállalkozik	tilt_freq2	lakok/lakom	vállalkozik
foglalatoskodik	tilt_freq2	lakok/lakom	foglalatoskodik
áhítozik	tilt_freq2	lakok/lakom	áhítozik
vá©akozik	tilt_freq2	lakok/lakom	vágyakozik
dolgozik	tilt_freq2	lakok/lakom	dolgozik
búçúzik	tilt_freq2	lakok/lakom	búcsúzik
fázik	tilt_freq2	lakok/lakom	fázik
barátkozik	tilt_freq2	lakok/lakom	barátkozik
ha©atkozik	tilt_freq2	lakok/lakom	hagyatkozik
hősködik	tilt_freq2	lakok/lakom	hősködik
búçúzkodik	tilt_freq2	lakok/lakom	búcsúzkodik
kötődik	tilt_freq2	lakok/lakom	kötődik
unatkozik	tilt_freq2	lakok/lakom	unatkozik
ißo¥odik	tilt_freq2	lakok/lakom	iszonyodik
mutatkozik	tilt_freq2	lakok/lakom	mutatkozik
¥ugtalankodik	tilt_freq2	lakok/lakom	nyugtalankodik
támaßkodik	tilt_freq2	lakok/lakom	támaszkodik
töltekezik	tilt_freq2	lakok/lakom	töltekezik
őrködik	tilt_freq2	lakok/lakom	őrködik
alußik	tilt_freq2	lakok/lakom	aluszik
vá©ik	tilt_freq2	lakok/lakom	vágyik
jelentkezik	tilt_freq2	lakok/lakom	jelentkezik
panaßkodik	tilt_freq2	lakok/lakom	panaszkodik
találkozik	tilt_freq2	lakok/lakom	találkozik
borotválkozik	tilt_freq2	lakok/lakom	borotválkozik
Ωonglőrködik	tilt_freq2	lakok/lakom	zsonglőrködik
tetßik	tilt_freq2	lakok/lakom	tetszik
tiltakozik	tilt_freq2	lakok/lakom	tiltakozik
tájékozódik	tilt_freq2	lakok/lakom	tájékozódik
tevéke¥kedik	tilt_freq2	lakok/lakom	tevékenykedik
aggódik	tilt_freq2	lakok/lakom	aggódik
sajnálkozik	tilt_freq2	lakok/lakom	sajnálkozik
ßabadkozik	tilt_freq2	lakok/lakom	szabadkozik
kételkedik	tilt_freq2	lakok/lakom	kételkedik
álmodozik	tilt_freq2	lakok/lakom	álmodozik
vitatkozik	tilt_freq2	lakok/lakom	vitatkozik
próbálkozik	tilt_freq2	lakok/lakom	próbálkozik
gondolkozik	tilt_freq2	lakok/lakom	gondolkozik
érkezik	tilt_freq2	lakok/lakom	érkezik
undorodik	tilt_freq2	lakok/lakom	undorodik
ißik	tilt_freq2	lakok/lakom	iszik
ßé©enkezik	tilt_freq2	lakok/lakom	szégyenkezik
ßorgoskodik	tilt_freq2	lakok/lakom	szorgoskodik
kívánkozik	tilt_freq2	lakok/lakom	kívánkozik
átkozódik	tilt_freq2	lakok/lakom	átkozódik
játßadozik	tilt_freq2	lakok/lakom	játszadozik
tißtálkodik	tilt_freq2	lakok/lakom	tisztálkodik
fáradozik	tilt_freq2	lakok/lakom	fáradozik
jógázik	tilt_freq2	lakok/lakom	jógázik
vétkezik	tilt_freq2	lakok/lakom	vétkezik
fukarkodik	tilt_freq2	lakok/lakom	fukarkodik
húzódozik	tilt_freq2	lakok/lakom	húzódozik
álmélkodik	tilt_freq2	lakok/lakom	álmélkodik
zárkózik	tilt_freq2	lakok/lakom	zárkózik
hivatkozik	tilt_freq2	lakok/lakom	hivatkozik
ßándékozik	tilt_freq2	lakok/lakom	szándékozik
tapogatódzik	tilt_freq2	lakok/lakom	tapogatódzik
ßomorkodik	tilt_freq2	lakok/lakom	szomorkodik
korço¬ázik	tilt_freq2	lakok/lakom	korcsolyázik
ßomjúhozik	tilt_freq2	lakok/lakom	szomjúhozik
kopaßodik	tilt_freq2	lakok/lakom	kopaszodik
utálkozik	tilt_freq2	lakok/lakom	utálkozik
tipródik	tilt_freq2	lakok/lakom	tipródik
vonakodik	tilt_freq2	lakok/lakom	vonakodik
edződik	tilt_freq2	lakok/lakom	edződik
tréfálkozik	tilt_freq2	lakok/lakom	tréfálkozik
ódzkodik	tilt_freq2	lakok/lakom	ódzkodik
hálálkodik	tilt_freq2	lakok/lakom	hálálkodik
futballozik	tilt_freq2	lakok/lakom	futballozik
végződik	tilt_freq2	lakok/lakom	végződik
érintkezik	tilt_freq2	lakok/lakom	érintkezik
remé¥kedik	tilt_freq2	lakok/lakom	reménykedik
vigaßtalódik	tilt_freq2	lakok/lakom	vigasztalódik
álmodik	tilt_freq2	lakok/lakom	álmodik
¥újtózkodik	tilt_freq2	lakok/lakom	nyújtózkodik
művelődik	tilt_freq2	lakok/lakom	művelődik
diétázik	tilt_freq2	lakok/lakom	diétázik
gazdálkodik	tilt_freq2	lakok/lakom	gazdálkodik
lottózik	tilt_freq2	lakok/lakom	lottózik
játßik	tilt_freq2	lakok/lakom	játszik
lustálkodik	tilt_freq2	lakok/lakom	lustálkodik
bánkódik	tilt_freq2	lakok/lakom	bánkódik
következik	tilt_freq2	lakok/lakom	következik
ku†ázik	tilt_freq2	lakok/lakom	kutyázik
avatkozik	tilt_freq2	lakok/lakom	avatkozik
változik	tilt_freq2	lakok/lakom	változik
tamáskodik	tilt_freq2	lakok/lakom	tamáskodik
töltődik	tilt_freq2	lakok/lakom	töltődik
alkalmazkodik	tilt_freq2	lakok/lakom	alkalmazkodik
oßtozkodik	tilt_freq2	lakok/lakom	osztozkodik
aggodalmaskodik	tilt_freq2	lakok/lakom	aggodalmaskodik
törődik	tilt_freq2	lakok/lakom	törődik
kacérkodik	tilt_freq2	lakok/lakom	kacérkodik
magázódik	tilt_freq2	lakok/lakom	magázódik
tépelődik	tilt_freq2	lakok/lakom	tépelődik
turistáskodik	tilt_freq2	lakok/lakom	turistáskodik
takarékoskodik	tilt_freq2	lakok/lakom	takarékoskodik
utazik	tilt_freq2	lakok/lakom	utazik
költözik	tilt_freq2	lakok/lakom	költözik
bővelkedik	tilt_freq2	lakok/lakom	bővelkedik
rugaßkodik	tilt_freq2	lakok/lakom	rugaszkodik
hiá¥zik	tilt_freq2	lakok/lakom	hiányzik
hivalkodik	tilt_freq2	lakok/lakom	hivalkodik
gazdagodik	tilt_freq2	lakok/lakom	gazdagodik
çimpaßkodik	tilt_freq2	lakok/lakom	csimpaszkodik
viaskodik	tilt_freq2	lakok/lakom	viaskodik
ßánakozik	tilt_freq2	lakok/lakom	szánakozik
erőßakoskodik	tilt_freq2	lakok/lakom	erőszakoskodik
botránkozik	tilt_freq2	lakok/lakom	botránkozik
fogadkozik	tilt_freq2	lakok/lakom	fogadkozik
udvariaskodik	tilt_freq2	lakok/lakom	udvariaskodik
lázadozik	tilt_freq2	lakok/lakom	lázadozik
képzelődik	tilt_freq2	lakok/lakom	képzelődik
faggatózik	tilt_freq2	lakok/lakom	faggatózik
bábáskodik	tilt_freq2	lakok/lakom	bábáskodik
bűnhődik	tilt_freq2	lakok/lakom	bűnhődik
elmélkedik	tilt_freq2	lakok/lakom	elmélkedik
óvakodik	tilt_freq2	lakok/lakom	óvakodik
bizakodik	tilt_freq2	lakok/lakom	bizakodik
akaßkodik	tilt_freq2	lakok/lakom	akaszkodik
segédkezik	tilt_freq2	lakok/lakom	segédkezik
cigarettázik	tilt_freq2	lakok/lakom	cigarettázik
működik	tilt_freq2	lakok/lakom	működik
titkolózik	tilt_freq2	lakok/lakom	titkolózik
iparkodik	tilt_freq2	lakok/lakom	iparkodik
çókolózik	tilt_freq2	lakok/lakom	csókolózik
¥újtózik	tilt_freq2	lakok/lakom	nyújtózik
fuvolázik	tilt_freq2	lakok/lakom	fuvolázik
vaçorázik	tilt_freq2	lakok/lakom	vacsorázik
virágzik	tilt_freq2	lakok/lakom	virágzik
ítélkezik	tilt_freq2	lakok/lakom	ítélkezik
évődik	tilt_freq2	lakok/lakom	évődik
viΩgálódik	NA	lakok/lakom	vizsgálódik
tornázik	NA	lakok/lakom	tornázik
birkózik	NA	lakok/lakom	birkózik
erősködik	NA	lakok/lakom	erősködik
kiáltozik	NA	lakok/lakom	kiáltozik
ékeskedik	NA	lakok/lakom	ékeskedik
mesterkedik	NA	lakok/lakom	mesterkedik
tornáßik	NA	lakok/lakom	tornászik
ingadozik	NA	lakok/lakom	ingadozik
viΩgázik	NA	lakok/lakom	vizsgázik
çellózik	NA	lakok/lakom	csellózik
búslakodik	NA	lakok/lakom	búslakodik
hozakodik	NA	lakok/lakom	hozakodik
bosßankodik	NA	lakok/lakom	bosszankodik
há¥kolódik	NA	lakok/lakom	hánykolódik
hadakozik	NA	lakok/lakom	hadakozik
ábrándozik	NA	lakok/lakom	ábrándozik
tegeződik	NA	lakok/lakom	tegeződik
tanakodik	NA	lakok/lakom	tanakodik
té¥kedik	NA	lakok/lakom	ténykedik
tengődik	NA	lakok/lakom	tengődik
rágódik	NA	lakok/lakom	rágódik
Ωörtölődik	NA	lakok/lakom	zsörtölődik
seré¥kedik	NA	lakok/lakom	serénykedik
bizo¥talankodik	NA	lakok/lakom	bizonytalankodik
ütközik	NA	lakok/lakom	ütközik
kívánçiskodik	NA	lakok/lakom	kíváncsiskodik
ólálkodik	NA	lakok/lakom	ólálkodik
elhatárolódik	NA	lakok/lakom	elhatárolódik
sikoltozik	NA	lakok/lakom	sikoltozik
esedezik	NA	lakok/lakom	esedezik
veßődik	NA	lakok/lakom	vesződik
erőlködik	NA	lakok/lakom	erőlködik
kontárkodik	NA	lakok/lakom	kontárkodik
ßórakozik	NA	lakok/lakom	szórakozik
makaçkodik	NA	lakok/lakom	makacskodik
autózik	NA	lakok/lakom	autózik
felejtkezik	NA	lakok/lakom	felejtkezik
ölelkezik	NA	lakok/lakom	ölelkezik
kapaßkodik	NA	lakok/lakom	kapaszkodik
tüsténkedik	NA	lakok/lakom	tüsténkedik
lelombozódik	NA	lakok/lakom	lelombozódik
vakaródzik	NA	lakok/lakom	vakaródzik
kétkedik	NA	lakok/lakom	kétkedik
erősödik	NA	lakok/lakom	erősödik
kajakozik	NA	lakok/lakom	kajakozik
alázkodik	NA	lakok/lakom	alázkodik
bölçelkedik	NA	lakok/lakom	bölcselkedik
búvárkodik	NA	lakok/lakom	búvárkodik
fa©oskodik	NA	lakok/lakom	fagyoskodik
sí¥lődik	NA	lakok/lakom	sínylődik
©őződik	NA	lakok/lakom	győződik
úßik	NA	lakok/lakom	úszik
lelkesedik	NA	lakok/lakom	lelkesedik
moso¬odik	NA	lakok/lakom	mosolyodik
ßövetkezik	NA	lakok/lakom	szövetkezik
páßtázik	NA	lakok/lakom	pásztázik
büßkélkedik	NA	lakok/lakom	büszkélkedik
çatlakozik	NA	lakok/lakom	csatlakozik
kardoskodik	NA	lakok/lakom	kardoskodik
gonoßkodik	NA	lakok/lakom	gonoszkodik
viselkedik	NA	lakok/lakom	viselkedik
álmosodik	NA	lakok/lakom	álmosodik
pironkodik	NA	lakok/lakom	pironkodik
idegenkedik	NA	lakok/lakom	idegenkedik
sodródik	NA	lakok/lakom	sodródik
példálózik	NA	lakok/lakom	példálózik
alkudozik	NA	lakok/lakom	alkudozik
rázkódik	NA	lakok/lakom	rázkódik
költözködik	NA	lakok/lakom	költözködik
röplabdázik	NA	lakok/lakom	röplabdázik
ßegődik	NA	lakok/lakom	szegődik
öltözik	NA	lakok/lakom	öltözik
méltatlankodik	NA	lakok/lakom	méltatlankodik
ßeré¥kedik	NA	lakok/lakom	szerénykedik
rázódik	NA	lakok/lakom	rázódik
tobzódik	NA	lakok/lakom	tobzódik
terjeßkedik	NA	lakok/lakom	terjeszkedik
fiatalodik	NA	lakok/lakom	fiatalodik
iri©kedik	NA	lakok/lakom	irigykedik
ma©arázkodik	NA	lakok/lakom	magyarázkodik
elbizo¥talanodik	NA	lakok/lakom	elbizonytalanodik
ü©ködik	NA	lakok/lakom	ügyködik
méhéßkedik	NA	lakok/lakom	méhészkedik
settenkedik	NA	lakok/lakom	settenkedik
puhatolózik	NA	lakok/lakom	puhatolózik
fulladozik	NA	lakok/lakom	fulladozik
kapçolódik	NA	lakok/lakom	kapcsolódik
várakozik	NA	lakok/lakom	várakozik
kérdezősködik	NA	lakok/lakom	kérdezősködik
vendégeskedik	NA	lakok/lakom	vendégeskedik
ßínéßkedik	NA	lakok/lakom	színészkedik
rosßalkodik	NA	lakok/lakom	rosszalkodik
ßőrösödik	NA	lakok/lakom	szőrösödik
uralkodik	NA	lakok/lakom	uralkodik
lábadozik	NA	lakok/lakom	lábadozik
éjßakázik	NA	lakok/lakom	éjszakázik
fo¬tatódik	NA	lakok/lakom	folytatódik
őrlődik	NA	lakok/lakom	őrlődik
vitézkedik	NA	lakok/lakom	vitézkedik
izmosodik	NA	lakok/lakom	izmosodik
he¬ezkedik	NA	lakok/lakom	helyezkedik
fésülködik	NA	lakok/lakom	fésülködik
kaparáßik	NA	lakok/lakom	kaparászik
na©képűsködik	NA	lakok/lakom	nagyképűsködik
kötözködik	NA	lakok/lakom	kötözködik
zö†kölődik	NA	lakok/lakom	zötykölődik
formálódik	NA	lakok/lakom	formálódik
vagdalkozik	NA	lakok/lakom	vagdalkozik
kalózkodik	NA	lakok/lakom	kalózkodik
botladozik	NA	lakok/lakom	botladozik
vízilabdázik	NA	lakok/lakom	vízilabdázik
késlekedik	NA	lakok/lakom	késlekedik
specializálódik	NA	lakok/lakom	specializálódik
ugrándozik	NA	lakok/lakom	ugrándozik
©űlölködik	NA	lakok/lakom	gyűlölködik
zúgolódik	NA	lakok/lakom	zúgolódik
élcelődik	NA	lakok/lakom	élcelődik
¥álazik	NA	lakok/lakom	nyálazik
esik	NA	lakok/lakom	esik
roskadozik	NA	lakok/lakom	roskadozik
féßkelődik	NA	lakok/lakom	fészkelődik
rángatózik	NA	lakok/lakom	rángatózik
teázik	NA	lakok/lakom	teázik
különcködik	NA	lakok/lakom	különcködik
ßitkozódik	NA	lakok/lakom	szitkozódik
betegeskedik	NA	lakok/lakom	betegeskedik
vádaskodik	NA	lakok/lakom	vádaskodik
rejtőzik	NA	lakok/lakom	rejtőzik
házasodik	NA	lakok/lakom	házasodik
feledkezik	NA	lakok/lakom	feledkezik
bo¥olódik	NA	lakok/lakom	bonyolódik
berzenkedik	NA	lakok/lakom	berzenkedik
vörösödik	NA	lakok/lakom	vörösödik
érettségizik	NA	lakok/lakom	érettségizik
sértődik	NA	lakok/lakom	sértődik
vetődik	NA	lakok/lakom	vetődik
sóhajtozik	NA	lakok/lakom	sóhajtozik
magasodik	NA	lakok/lakom	magasodik
báméßkodik	NA	lakok/lakom	bámészkodik
mérgelődik	NA	lakok/lakom	mérgelődik
ösßehaverkodik	NA	lakok/lakom	összehaverkodik
rádiózik	NA	lakok/lakom	rádiózik
viccelődik	NA	lakok/lakom	viccelődik
sáfárkodik	NA	lakok/lakom	sáfárkodik
garázdálkodik	NA	lakok/lakom	garázdálkodik
siránkozik	NA	lakok/lakom	siránkozik
óvatoskodik	NA	lakok/lakom	óvatoskodik
bizo¥osodik	NA	lakok/lakom	bizonyosodik
zuha¥ozik	NA	lakok/lakom	zuhanyozik
dudoráßik	NA	lakok/lakom	dudorászik
bíbelődik	NA	lakok/lakom	bíbelődik
tápáßkodik	NA	lakok/lakom	tápászkodik
eßik	NA	lakok/lakom	eszik
távolodik	NA	lakok/lakom	távolodik
jeleskedik	NA	lakok/lakom	jeleskedik
kukacoskodik	NA	lakok/lakom	kukacoskodik
telítődik	NA	lakok/lakom	telítődik
kertéßkedik	NA	lakok/lakom	kertészkedik
lázasodik	NA	lakok/lakom	lázasodik
rimánkodik	NA	lakok/lakom	rimánkodik
randizik	NA	lakok/lakom	randizik
vergődik	NA	lakok/lakom	vergődik
hangolódik	NA	lakok/lakom	hangolódik
józanodik	NA	lakok/lakom	józanodik
visßakozik	NA	lakok/lakom	visszakozik
igazodik	NA	lakok/lakom	igazodik
citerázik	NA	lakok/lakom	citerázik
kosárlabdázik	NA	lakok/lakom	kosárlabdázik
ereßkedik	NA	lakok/lakom	ereszkedik
ßerelmeskedik	NA	lakok/lakom	szerelmeskedik
pipiskedik	NA	lakok/lakom	pipiskedik
okosodik	NA	lakok/lakom	okosodik
tétovázik	NA	lakok/lakom	tétovázik
orientálódik	NA	lakok/lakom	orientálódik
leskelődik	NA	lakok/lakom	leskelődik
élvezkedik	NA	lakok/lakom	élvezkedik
gömbö¬ödik	NA	lakok/lakom	gömbölyödik
reggelizik	NA	lakok/lakom	reggelizik
bajlódik	NA	lakok/lakom	bajlódik
hajladozik	NA	lakok/lakom	hajladozik
húzódik	NA	lakok/lakom	húzódik
kellemetlenkedik	NA	lakok/lakom	kellemetlenkedik
kuporodik	NA	lakok/lakom	kuporodik
paráználkodik	NA	lakok/lakom	paráználkodik
leledzik	NA	lakok/lakom	leledzik
ismerkedik	NA	lakok/lakom	ismerkedik
vitázik	NA	lakok/lakom	vitázik
vívódik	NA	lakok/lakom	vívódik
lábatlankodik	NA	lakok/lakom	lábatlankodik
epekedik	tilt_freq1	lakok/lakom	epekedik
¥űglődik	tilt_freq1	lakok/lakom	nyűglődik
falatozik	tilt_freq1	lakok/lakom	falatozik
alakoskodik	tilt_freq1	lakok/lakom	alakoskodik
vonatozik	tilt_freq1	lakok/lakom	vonatozik
bókláßik	tilt_freq1	lakok/lakom	bóklászik
tétlenkedik	tilt_freq1	lakok/lakom	tétlenkedik
pecázik	tilt_freq1	lakok/lakom	pecázik
adakozik	tilt_freq1	lakok/lakom	adakozik
áskálódik	tilt_freq1	lakok/lakom	áskálódik
túrázik	tilt_freq1	lakok/lakom	túrázik
sopánkodik	tilt_freq1	lakok/lakom	sopánkodik
ßedelőzködik	tilt_freq1	lakok/lakom	szedelőzködik
çigázik	tilt_freq1	lakok/lakom	csigázik
okoskodik	tilt_freq1	lakok/lakom	okoskodik
közlekedik	tilt_freq1	lakok/lakom	közlekedik
ßagláßik	tilt_freq1	lakok/lakom	szaglászik
kéßülődik	tilt_freq1	lakok/lakom	készülődik
mozgolódik	tilt_freq1	lakok/lakom	mozgolódik
építkezik	tilt_freq1	lakok/lakom	építkezik
ásítozik	tilt_freq1	lakok/lakom	ásítozik
árulkodik	tilt_freq1	lakok/lakom	árulkodik
akadékoskodik	tilt_freq1	lakok/lakom	akadékoskodik
ámuldozik	tilt_freq1	lakok/lakom	ámuldozik
marháskodik	tilt_freq1	lakok/lakom	marháskodik
telepßik	tilt_freq1	lakok/lakom	telepszik
meréßkedik	tilt_freq1	lakok/lakom	merészkedik
bogaráßik	tilt_freq1	lakok/lakom	bogarászik
ßemlélődik	tilt_freq1	lakok/lakom	szemlélődik
nézelődik	tilt_freq1	lakok/lakom	nézelődik
ßocializálódik	tilt_freq1	lakok/lakom	szocializálódik
kézilabdázik	tilt_freq1	lakok/lakom	kézilabdázik
aßalódik	tilt_freq1	lakok/lakom	aszalódik
védekezik	tilt_freq1	lakok/lakom	védekezik
leselkedik	tilt_freq1	lakok/lakom	leselkedik
kérődzik	tilt_freq1	lakok/lakom	kérődzik
döglődik	tilt_freq1	lakok/lakom	döglődik
értekezik	tilt_freq1	lakok/lakom	értekezik
türelmetlenkedik	tilt_freq1	lakok/lakom	türelmetlenkedik
lepődik	tilt_freq1	lakok/lakom	lepődik
hintázik	tilt_freq1	lakok/lakom	hintázik
olvadozik	tilt_freq1	lakok/lakom	olvadozik
rendezkedik	tilt_freq1	lakok/lakom	rendezkedik
forgolódik	tilt_freq1	lakok/lakom	forgolódik
kosarazik	tilt_freq1	lakok/lakom	kosarazik
túlórázik	tilt_freq1	lakok/lakom	túlórázik
kutakodik	tilt_freq1	lakok/lakom	kutakodik
ßeretkezik	tilt_freq1	lakok/lakom	szeretkezik
bohóckodik	tilt_freq1	lakok/lakom	bohóckodik
ßökik	tilt_freq1	lakok/lakom	szökik
feldobódik	tilt_freq1	lakok/lakom	feldobódik
ßerződik	tilt_freq1	lakok/lakom	szerződik
ßabá¬talankodik	tilt_freq1	lakok/lakom	szabálytalankodik
kerékpározik	tilt_freq1	lakok/lakom	kerékpározik
harmonikázik	tilt_freq1	lakok/lakom	harmonikázik
ellenkezik	tilt_freq1	lakok/lakom	ellenkezik
játßódik	tilt_freq1	lakok/lakom	játszódik
engedelmeskedik	tilt_freq1	lakok/lakom	engedelmeskedik
bűvéßkedik	tilt_freq1	lakok/lakom	bűvészkedik
perlekedik	tilt_freq1	lakok/lakom	perlekedik
fo©ókúrázik	tilt_freq1	lakok/lakom	fogyókúrázik
ßaporodik	tilt_freq1	lakok/lakom	szaporodik
çalódik	tilt_freq1	lakok/lakom	csalódik
pompázik	tilt_freq1	lakok/lakom	pompázik
hangoskodik	tilt_freq1	lakok/lakom	hangoskodik
ü©etlenkedik	tilt_freq1	lakok/lakom	ügyetlenkedik
költekezik	tilt_freq1	lakok/lakom	költekezik
küßködik	tilt_freq1	lakok/lakom	küszködik
kapálódzik	tilt_freq1	lakok/lakom	kapálódzik
kézimunkázik	tilt_freq1	lakok/lakom	kézimunkázik
informálódik	tilt_freq1	lakok/lakom	informálódik
vágódik	tilt_freq1	lakok/lakom	vágódik
ü©eskedik	tilt_freq1	lakok/lakom	ügyeskedik
hajózik	tilt_freq1	lakok/lakom	hajózik
fejlődik	tilt_freq1	lakok/lakom	fejlődik
ßomorodik	tilt_freq1	lakok/lakom	szomorodik
regenerálódik	tilt_freq1	lakok/lakom	regenerálódik
autókázik	tilt_freq1	lakok/lakom	autókázik
harangozik	tilt_freq1	lakok/lakom	harangozik
tökölődik	tilt_freq1	lakok/lakom	tökölődik
ßáguldozik	tilt_freq1	lakok/lakom	száguldozik
réßesedik	tilt_freq1	lakok/lakom	részesedik
tántorodik	tilt_freq1	lakok/lakom	tántorodik
alaço¥odik	tilt_freq1	lakok/lakom	alacsonyodik
ta¥ázik	tilt_freq1	lakok/lakom	tanyázik
haldoklik	tilt_freq1	lakok/lakom	haldoklik
hitetlenkedik	tilt_freq1	lakok/lakom	hitetlenkedik
kerekedik	tilt_freq1	lakok/lakom	kerekedik
¥áladzik	tilt_freq1	lakok/lakom	nyáladzik
çapódik	tilt_freq1	lakok/lakom	csapódik
vetemedik	tilt_freq1	lakok/lakom	vetemedik
ökörködik	tilt_freq1	lakok/lakom	ökörködik
verejtékezik	tilt_freq1	lakok/lakom	verejtékezik
nekiveselkedik	tilt_freq1	lakok/lakom	nekiveselkedik
bakizik	tilt_freq1	lakok/lakom	bakizik
bújóçkázik	tilt_freq1	lakok/lakom	bújócskázik
mentegetőzik	tilt_freq1	lakok/lakom	mentegetőzik
pingpongozik	tilt_freq1	lakok/lakom	pingpongozik
kávézik	tilt_freq1	lakok/lakom	kávézik
gú¥olódik	tilt_freq1	lakok/lakom	gúnyolódik
lélegzik	tilt_freq1	lakok/lakom	lélegzik
kár†ázik	tilt_freq1	lakok/lakom	kártyázik
kereskedik	tilt_freq1	lakok/lakom	kereskedik
fa¥alodik	tilt_freq1	lakok/lakom	fanyalodik
poénkodik	tilt_freq1	lakok/lakom	poénkodik
terpeßkedik	tilt_freq1	lakok/lakom	terpeszkedik
furu¬ázik	tilt_freq1	lakok/lakom	furulyázik
hatódik	tilt_freq1	lakok/lakom	hatódik
levegőzik	tilt_freq1	lakok/lakom	levegőzik
ejtőzik	tilt_freq1	lakok/lakom	ejtőzik
pereskedik	tilt_freq1	lakok/lakom	pereskedik
pipázik	tilt_freq1	lakok/lakom	pipázik
kérkedik	tilt_freq1	lakok/lakom	kérkedik
éhezik	tilt_freq1	lakok/lakom	éhezik
elégedetlenkedik	tilt_freq1	lakok/lakom	elégedetlenkedik
vélekedik	tilt_freq1	lakok/lakom	vélekedik
háborodik	tilt_freq1	lakok/lakom	háborodik
hízik	tilt_freq1	lakok/lakom	hízik
értetlenkedik	tilt_freq1	lakok/lakom	értetlenkedik
Ωírosodik	tilt_freq1	lakok/lakom	zsírosodik
morfondírozik	tilt_freq1	lakok/lakom	morfondírozik
művéßkedik	tilt_freq1	lakok/lakom	művészkedik
kínlódik	tilt_freq1	lakok/lakom	kínlódik
pá¬ázik	tilt_freq1	lakok/lakom	pályázik
húzódzkodik	tilt_freq1	lakok/lakom	húzódzkodik
taktikázik	tilt_freq1	lakok/lakom	taktikázik
ordítozik	tilt_freq1	lakok/lakom	ordítozik
kekeckedik	tilt_freq1	lakok/lakom	kekeckedik
veselkedik	tilt_freq1	lakok/lakom	veselkedik
időzik	tilt_freq1	lakok/lakom	időzik
közeledik	tilt_freq1	lakok/lakom	közeledik
tempózik	tilt_freq1	lakok/lakom	tempózik
vitorlázik	tilt_freq1	lakok/lakom	vitorlázik
çúßik	tilt_freq1	lakok/lakom	csúszik
pofátlankodik	tilt_freq1	lakok/lakom	pofátlankodik
rohangáßik	tilt_freq1	lakok/lakom	rohangászik
oldódik	tilt_freq1	lakok/lakom	oldódik
kotoráßik	tilt_freq1	lakok/lakom	kotorászik
teljesedik	tilt_freq1	lakok/lakom	teljesedik
çavarodik	tilt_freq1	lakok/lakom	csavarodik
idegeskedik	tilt_freq1	lakok/lakom	idegeskedik
kerekezik	tilt_freq1	lakok/lakom	kerekezik
vetkőzik	tilt_freq1	lakok/lakom	vetkőzik
karikázik	tilt_freq1	lakok/lakom	karikázik
káßálódik	tilt_freq1	lakok/lakom	kászálódik
mélázik	tilt_freq1	lakok/lakom	mélázik
morgolódik	tilt_freq1	lakok/lakom	morgolódik
törölközik	tilt_freq1	lakok/lakom	törölközik
ßivarozik	tilt_freq1	lakok/lakom	szivarozik
hibázik	tilt_freq1	lakok/lakom	hibázik
ele©edik	tilt_freq1	lakok/lakom	elegyedik
ßerençétlenkedik	tilt_freq1	lakok/lakom	szerencsétlenkedik
káromkodik	tilt_freq1	lakok/lakom	káromkodik
hazudozik	tilt_freq1	lakok/lakom	hazudozik
kedveskedik	tilt_freq1	lakok/lakom	kedveskedik
táborozik	tilt_freq1	lakok/lakom	táborozik
élősködik	tilt_freq1	lakok/lakom	élősködik
ßarakodik	tilt_freq1	lakok/lakom	szarakodik
bujdosik	tilt_freq1	lakok/lakom	bujdosik
futamodik	tilt_freq1	lakok/lakom	futamodik
nedvesedik	tilt_freq1	lakok/lakom	nedvesedik
çuklik	tilt_freq1	lakok/lakom	csuklik
háborúzik	tilt_freq1	lakok/lakom	háborúzik
futkározik	tilt_freq1	lakok/lakom	futkározik
koçikázik	tilt_freq1	lakok/lakom	kocsikázik
cipekedik	tilt_freq1	lakok/lakom	cipekedik
e©ezik	tilt_freq1	lakok/lakom	egyezik
kezdődik	tilt_freq1	lakok/lakom	kezdődik
elmélázik	tilt_freq1	lakok/lakom	elmélázik
napozik	tilt_freq1	lakok/lakom	napozik
sütkérezik	tilt_freq1	lakok/lakom	sütkérezik
haverkodik	tilt_freq1	lakok/lakom	haverkodik
ébredezik	tilt_freq1	lakok/lakom	ébredezik
jóllakik	tilt_freq1	lakok/lakom	jóllakik
érdeklődik	tilt_freq1	lakok/lakom	érdeklődik
vizesedik	tilt_freq1	lakok/lakom	vizesedik
lelkendezik	tilt_freq1	lakok/lakom	lelkendezik
aßik	tilt_freq1	lakok/lakom	aszik
kön¥ezik	tilt_freq1	lakok/lakom	könnyezik
kétségbeesik	tilt_freq1	lakok/lakom	kétségbeesik
ßemé¬eskedik	tilt_freq1	lakok/lakom	személyeskedik
botlik	tilt_freq1	lakok/lakom	botlik
©őzködik	tilt_freq1	lakok/lakom	győzködik
tenißezik	tilt_freq1	lakok/lakom	teniszezik
féltéke¥kedik	tilt_freq1	lakok/lakom	féltékenykedik
örvendezik	tilt_freq1	lakok/lakom	örvendezik
hü¬éskedik	tilt_freq1	lakok/lakom	hülyéskedik
emlékezik	tilt_freq1	lakok/lakom	emlékezik
tartozik	tilt_freq1	lakok/lakom	tartozik
történik	cvcik	cselekszenek/cselekednek	történik
működik	cvcik	cselekszenek/cselekednek	működik
tűnik	cvcik	cselekszenek/cselekednek	tűnik
tartozik	cvcik	cselekszenek/cselekednek	tartozik
válik	cvcik	cselekszenek/cselekednek	válik
látßik	ccik	cselekszenek/cselekednek	látszik
létezik	cvcik	cselekszenek/cselekednek	létezik
dolgozik	cvcik	cselekszenek/cselekednek	dolgozik
tetßik	ccik	cselekszenek/cselekednek	tetszik
kezdődik	cvcik	cselekszenek/cselekednek	kezdődik
érkezik	cvcik	cselekszenek/cselekednek	érkezik
jelenik	cvcik	cselekszenek/cselekednek	jelenik
játßik	ccik	cselekszenek/cselekednek	játszik
változik	cvcik	cselekszenek/cselekednek	változik
¥ílik	cvcik	cselekszenek/cselekednek	nyílik
fo¬ik	cvcik	cselekszenek/cselekednek	folyik
ßármazik	cvcik	cselekszenek/cselekednek	származik
múlik	cvcik	cselekszenek/cselekednek	múlik
emelkedik	cvcik	cselekszenek/cselekednek	emelkedik
ßületik	cvcik	cselekszenek/cselekednek	születik
rejlik	ccik	cselekszenek/cselekednek	rejlik
adódik	cvcik	cselekszenek/cselekednek	adódik
lakik	cvcik	cselekszenek/cselekednek	lakik
vá©ik	cvcik	cselekszenek/cselekednek	vágyik
fejlődik	cvcik	cselekszenek/cselekednek	fejlődik
telik	cvcik	cselekszenek/cselekednek	telik
játßódik	cvcik	cselekszenek/cselekednek	játszódik
kötődik	cvcik	cselekszenek/cselekednek	kötődik
utazik	cvcik	cselekszenek/cselekednek	utazik
fűződik	cvcik	cselekszenek/cselekednek	fűződik
bízik	cvcik	cselekszenek/cselekednek	bízik
húzódik	cvcik	cselekszenek/cselekednek	húzódik
távozik	cvcik	cselekszenek/cselekednek	távozik
közeledik	cvcik	cselekszenek/cselekednek	közeledik
ütközik	cvcik	cselekszenek/cselekednek	ütközik
¥úlik	cvcik	cselekszenek/cselekednek	nyúlik
e©ezik	cvcik	cselekszenek/cselekednek	egyezik
uralkodik	cvcik	cselekszenek/cselekednek	uralkodik
ßűnik	cvcik	cselekszenek/cselekednek	szűnik
erősödik	cvcik	cselekszenek/cselekednek	erősödik
alapßik	ccik	cselekszenek/cselekednek	alapszik
fokozódik	cvcik	cselekszenek/cselekednek	fokozódik
çúßik	cvcik	cselekszenek/cselekednek	csúszik
igazodik	cvcik	cselekszenek/cselekednek	igazodik
keveredik	cvcik	cselekszenek/cselekednek	keveredik
érződik	cvcik	cselekszenek/cselekednek	érződik
veßik	cvcik	cselekszenek/cselekednek	veszik
ígérkezik	cvcik	cselekszenek/cselekednek	ígérkezik
hazudik	cvcik	cselekszenek/cselekednek	hazudik
végződik	cvcik	cselekszenek/cselekednek	végződik
késik	cvcik	cselekszenek/cselekednek	késik
törődik	cvcik	cselekszenek/cselekednek	törődik
aggódik	cvcik	cselekszenek/cselekednek	aggódik
oldódik	cvcik	cselekszenek/cselekednek	oldódik
fejeződik	cvcik	cselekszenek/cselekednek	fejeződik
bújik	cvcik	cselekszenek/cselekednek	bújik
képződik	cvcik	cselekszenek/cselekednek	képződik
árulkodik	cvcik	cselekszenek/cselekednek	árulkodik
bánik	cvcik	cselekszenek/cselekednek	bánik
tevődik	cvcik	cselekszenek/cselekednek	tevődik
rejtőzik	cvcik	cselekszenek/cselekednek	rejtőzik
bukik	cvcik	cselekszenek/cselekednek	bukik
jólesik	cvcik	cselekszenek/cselekednek	jólesik
adatik	cvcik	cselekszenek/cselekednek	adatik
hajlik	ccik	cselekszenek/cselekednek	hajlik
vélekedik	cvcik	cselekszenek/cselekednek	vélekedik
©űlik	cvcik	cselekszenek/cselekednek	gyűlik
rémlik	ccik	cselekszenek/cselekednek	rémlik
lakozik	cvcik	cselekszenek/cselekednek	lakozik
álmodik	cvcik	cselekszenek/cselekednek	álmodik
ßívódik	cvcik	cselekszenek/cselekednek	szívódik
pá¬ázik	cvcik	cselekszenek/cselekednek	pályázik
nehezedik	cvcik	cselekszenek/cselekednek	nehezedik
imádkozik	cvcik	cselekszenek/cselekednek	imádkozik
íródik	cvcik	cselekszenek/cselekednek	íródik
búçúzik	cvcik	cselekszenek/cselekednek	búcsúzik
hibázik	cvcik	cselekszenek/cselekednek	hibázik
máßik	cvcik	cselekszenek/cselekednek	mászik
költözik	cvcik	cselekszenek/cselekednek	költözik
törlődik	cvcik	cselekszenek/cselekednek	törlődik
oßtozik	cvcik	cselekszenek/cselekednek	osztozik
kopik	cvcik	cselekszenek/cselekednek	kopik
védekezik	cvcik	cselekszenek/cselekednek	védekezik
építkezik	cvcik	cselekszenek/cselekednek	építkezik
öregßik	ccik	cselekszenek/cselekednek	öregszik
esküßik	cvcik	cselekszenek/cselekednek	esküszik
küßködik	cvcik	cselekszenek/cselekednek	küszködik
törik	cvcik	cselekszenek/cselekednek	törik
ingadozik	cvcik	cselekszenek/cselekednek	ingadozik
tolódik	cvcik	cselekszenek/cselekednek	tolódik
kerekedik	cvcik	cselekszenek/cselekednek	kerekedik
várakozik	cvcik	cselekszenek/cselekednek	várakozik
töltődik	cvcik	cselekszenek/cselekednek	töltődik
çapódik	cvcik	cselekszenek/cselekednek	csapódik
záródik	cvcik	cselekszenek/cselekednek	záródik
vadáßik	cvcik	cselekszenek/cselekednek	vadászik
vonzódik	cvcik	cselekszenek/cselekednek	vonzódik
vetődik	cvcik	cselekszenek/cselekednek	vetődik
pompázik	cvcik	cselekszenek/cselekednek	pompázik
éhezik	cvcik	cselekszenek/cselekednek	éhezik
fázik	cvcik	cselekszenek/cselekednek	fázik
kúßik	cvcik	cselekszenek/cselekednek	kúszik
adózik	cvcik	cselekszenek/cselekednek	adózik
károsodik	cvcik	cselekszenek/cselekednek	károsodik
ßökik	cvcik	cselekszenek/cselekednek	szökik
akadozik	cvcik	cselekszenek/cselekednek	akadozik
sodródik	cvcik	cselekszenek/cselekednek	sodródik
tagolódik	cvcik	cselekszenek/cselekednek	tagolódik
sorakozik	cvcik	cselekszenek/cselekednek	sorakozik
unatkozik	cvcik	cselekszenek/cselekednek	unatkozik
távolodik	cvcik	cselekszenek/cselekednek	távolodik
fáradozik	cvcik	cselekszenek/cselekednek	fáradozik
izzik	ccik	cselekszenek/cselekednek	izzik
avatkozik	cvcik	cselekszenek/cselekednek	avatkozik
hízik	cvcik	cselekszenek/cselekednek	hízik
álmodozik	cvcik	cselekszenek/cselekednek	álmodozik
rakódik	cvcik	cselekszenek/cselekednek	rakódik
ülésezik	cvcik	cselekszenek/cselekednek	ülésezik
turnézik	cvcik	cselekszenek/cselekednek	turnézik
bűzlik	ccik	cselekszenek/cselekednek	bűzlik
sűrűsödik	cvcik	cselekszenek/cselekednek	sűrűsödik
öröklődik	cvcik	cselekszenek/cselekednek	öröklődik
tárolódik	cvcik	cselekszenek/cselekednek	tárolódik
sötétedik	cvcik	cselekszenek/cselekednek	sötétedik
porosodik	cvcik	cselekszenek/cselekednek	porosodik
fonódik	cvcik	cselekszenek/cselekednek	fonódik
vergődik	cvcik	cselekszenek/cselekednek	vergődik
ítélkezik	cvcik	cselekszenek/cselekednek	ítélkezik
zárkózik	cvcik	cselekszenek/cselekednek	zárkózik
ötvöződik	cvcik	cselekszenek/cselekednek	ötvöződik
havazik	cvcik	cselekszenek/cselekednek	havazik
ta¥ázik	cvcik	cselekszenek/cselekednek	tanyázik
ßopik	cvcik	cselekszenek/cselekednek	szopik
értetődik	cvcik	cselekszenek/cselekednek	értetődik
ßegődik	cvcik	cselekszenek/cselekednek	szegődik
birkózik	cvcik	cselekszenek/cselekednek	birkózik
dívik	cvcik	cselekszenek/cselekednek	dívik
étkezik	cvcik	cselekszenek/cselekednek	étkezik
ßarik	cvcik	cselekszenek/cselekednek	szarik
értekezik	cvcik	cselekszenek/cselekednek	értekezik
terelődik	cvcik	cselekszenek/cselekednek	terelődik
ha¥atlik	ccik	cselekszenek/cselekednek	hanyatlik
ágazik	cvcik	cselekszenek/cselekednek	ágazik
felsejlik	ccik	cselekszenek/cselekednek	felsejlik
ismerßik	ccik	cselekszenek/cselekednek	ismerszik
tetőzik	cvcik	cselekszenek/cselekednek	tetőzik
gitározik	cvcik	cselekszenek/cselekednek	gitározik
őrködik	cvcik	cselekszenek/cselekednek	őrködik
çalódik	cvcik	cselekszenek/cselekednek	csalódik
ßerződik	cvcik	cselekszenek/cselekednek	szerződik
ßomjazik	cvcik	cselekszenek/cselekednek	szomjazik
kamatozik	cvcik	cselekszenek/cselekednek	kamatozik
lepődik	cvcik	cselekszenek/cselekednek	lepődik
ingázik	cvcik	cselekszenek/cselekednek	ingázik
ßövődik	cvcik	cselekszenek/cselekednek	szövődik
időzik	cvcik	cselekszenek/cselekednek	időzik
hißtizik	cvcik	cselekszenek/cselekednek	hisztizik
focizik	cvcik	cselekszenek/cselekednek	focizik
vétkezik	cvcik	cselekszenek/cselekednek	vétkezik
bajlódik	cvcik	cselekszenek/cselekednek	bajlódik
érlelődik	cvcik	cselekszenek/cselekednek	érlelődik
élesedik	cvcik	cselekszenek/cselekednek	élesedik
mérkőzik	cvcik	cselekszenek/cselekednek	mérkőzik
irtózik	cvcik	cselekszenek/cselekednek	irtózik
erőlködik	cvcik	cselekszenek/cselekednek	erőlködik
telítődik	cvcik	cselekszenek/cselekednek	telítődik
viΩgázik	cvcik	cselekszenek/cselekednek	vizsgázik
állapodik	cvcik	cselekszenek/cselekednek	állapodik
vitázik	cvcik	cselekszenek/cselekednek	vitázik
ßűrődik	cvcik	cselekszenek/cselekednek	szűrődik
tojik	cvcik	cselekszenek/cselekednek	tojik
nézelődik	cvcik	cselekszenek/cselekednek	nézelődik
iratkozik	cvcik	cselekszenek/cselekednek	iratkozik
sejlik	ccik	cselekszenek/cselekednek	sejlik
ßóródik	cvcik	cselekszenek/cselekednek	szóródik
te¥éßik	cvcik	cselekszenek/cselekednek	tenyészik
ódzkodik	cvcik	cselekszenek/cselekednek	ódzkodik
autózik	cvcik	cselekszenek/cselekednek	autózik
betegßik	ccik	cselekszenek/cselekednek	betegszik
öltözik	cvcik	cselekszenek/cselekednek	öltözik
okoskodik	cvcik	cselekszenek/cselekednek	okoskodik
ßikrázik	cvcik	cselekszenek/cselekednek	szikrázik
akarózik	cvcik	cselekszenek/cselekednek	akarózik
tagozódik	cvcik	cselekszenek/cselekednek	tagozódik
vonakodik	cvcik	cselekszenek/cselekednek	vonakodik
házasodik	cvcik	cselekszenek/cselekednek	házasodik
vá©ódik	cvcik	cselekszenek/cselekednek	vágyódik
datálódik	cvcik	cselekszenek/cselekednek	datálódik
ele©edik	cvcik	cselekszenek/cselekednek	elegyedik
vetkezik	cvcik	cselekszenek/cselekednek	vetkezik
verődik	cvcik	cselekszenek/cselekednek	verődik
ßokik	cvcik	cselekszenek/cselekednek	szokik
ü©ködik	cvcik	cselekszenek/cselekednek	ügyködik
kínlódik	cvcik	cselekszenek/cselekednek	kínlódik
vetemedik	cvcik	cselekszenek/cselekednek	vetemedik
baßik	cvcik	cselekszenek/cselekednek	baszik
böngéßik	cvcik	cselekszenek/cselekednek	böngészik
kérkedik	cvcik	cselekszenek/cselekednek	kérkedik
lábadozik	cvcik	cselekszenek/cselekednek	lábadozik
ará¥lik	ccik	cselekszenek/cselekednek	aránylik
lobbizik	cvcik	cselekszenek/cselekednek	lobbizik
horgáßik	cvcik	cselekszenek/cselekednek	horgászik
viaskodik	cvcik	cselekszenek/cselekednek	viaskodik
tekeredik	cvcik	cselekszenek/cselekednek	tekeredik
oßtódik	cvcik	cselekszenek/cselekednek	osztódik
tobzódik	cvcik	cselekszenek/cselekednek	tobzódik
rejtezik	cvcik	cselekszenek/cselekednek	rejtezik
hadakozik	cvcik	cselekszenek/cselekednek	hadakozik
cikázik	cvcik	cselekszenek/cselekednek	cikázik
hajózik	cvcik	cselekszenek/cselekednek	hajózik
ólálkodik	cvcik	cselekszenek/cselekednek	ólálkodik
tengődik	cvcik	cselekszenek/cselekednek	tengődik
ékelődik	cvcik	cselekszenek/cselekednek	ékelődik
élősködik	cvcik	cselekszenek/cselekednek	élősködik
hazudozik	cvcik	cselekszenek/cselekednek	hazudozik
illatozik	cvcik	cselekszenek/cselekednek	illatozik
tűnődik	cvcik	cselekszenek/cselekednek	tűnődik
kön¥ezik	cvcik	cselekszenek/cselekednek	könnyezik
çukódik	cvcik	cselekszenek/cselekednek	csukódik
©űrődik	cvcik	cselekszenek/cselekednek	gyűrődik
çírázik	cvcik	cselekszenek/cselekednek	csírázik
sértődik	cvcik	cselekszenek/cselekednek	sértődik
áhítozik	cvcik	cselekszenek/cselekednek	áhítozik
rágódik	cvcik	cselekszenek/cselekednek	rágódik
motorozik	cvcik	cselekszenek/cselekednek	motorozik
meghajlik	ccik	cselekszenek/cselekednek	meghajlik
undorodik	cvcik	cselekszenek/cselekednek	undorodik
rugózik	cvcik	cselekszenek/cselekednek	rugózik
çatázik	cvcik	cselekszenek/cselekednek	csatázik
iparkodik	cvcik	cselekszenek/cselekednek	iparkodik
kí©ózik	cvcik	cselekszenek/cselekednek	kígyózik
bókláßik	cvcik	cselekszenek/cselekednek	bóklászik
á©azódik	cvcik	cselekszenek/cselekednek	ágyazódik
diétázik	cvcik	cselekszenek/cselekednek	diétázik
őrlődik	cvcik	cselekszenek/cselekednek	őrlődik
jóllakik	cvcik	cselekszenek/cselekednek	jóllakik
díßlik	ccik	cselekszenek/cselekednek	díszlik
bizakodik	cvcik	cselekszenek/cselekednek	bizakodik
¥omódik	cvcik	cselekszenek/cselekednek	nyomódik
randizik	cvcik	cselekszenek/cselekednek	randizik
kenődik	cvcik	cselekszenek/cselekednek	kenődik
¥újtózik	cvcik	cselekszenek/cselekednek	nyújtózik
mosódik	cvcik	cselekszenek/cselekednek	mosódik
fűlik	cvcik	cselekszenek/cselekednek	fűlik
kávézik	cvcik	cselekszenek/cselekednek	kávézik
búvik	cvcik	cselekszenek/cselekednek	búvik
esteledik	cvcik	cselekszenek/cselekednek	esteledik
sikeredik	cvcik	cselekszenek/cselekednek	sikeredik
cigizik	cvcik	cselekszenek/cselekednek	cigizik
rázkódik	cvcik	cselekszenek/cselekednek	rázkódik
alkudik	cvcik	cselekszenek/cselekednek	alkudik
vetkőzik	cvcik	cselekszenek/cselekednek	vetkőzik
pofázik	cvcik	cselekszenek/cselekednek	pofázik
ékeskedik	cvcik	cselekszenek/cselekednek	ékeskedik
nemesedik	cvcik	cselekszenek/cselekednek	nemesedik
túrázik	cvcik	cselekszenek/cselekednek	túrázik
hibásodik	cvcik	cselekszenek/cselekednek	hibásodik
jógázik	cvcik	cselekszenek/cselekednek	jógázik
ßellőzik	cvcik	cselekszenek/cselekednek	szellőzik
fotózik	cvcik	cselekszenek/cselekednek	fotózik
té¥kedik	cvcik	cselekszenek/cselekednek	ténykedik
áradozik	cvcik	cselekszenek/cselekednek	áradozik
bánkódik	cvcik	cselekszenek/cselekednek	bánkódik
adakozik	cvcik	cselekszenek/cselekednek	adakozik
tornázik	cvcik	cselekszenek/cselekednek	tornázik
vívódik	cvcik	cselekszenek/cselekednek	vívódik
fehérlik	ccik	cselekszenek/cselekednek	fehérlik
kémkedik	cvcik	cselekszenek/cselekednek	kémkedik
káprázik	cvcik	cselekszenek/cselekednek	káprázik
finomodik	cvcik	cselekszenek/cselekednek	finomodik
dobálózik	cvcik	cselekszenek/cselekednek	dobálózik
kutakodik	cvcik	cselekszenek/cselekednek	kutakodik
hajtódik	cvcik	cselekszenek/cselekednek	hajtódik
melózik	cvcik	cselekszenek/cselekednek	melózik
©ötrődik	cvcik	cselekszenek/cselekednek	gyötrődik
tétovázik	cvcik	cselekszenek/cselekednek	tétovázik
párolódik	cvcik	cselekszenek/cselekednek	párolódik
ágaskodik	cvcik	cselekszenek/cselekednek	ágaskodik
elhajlik	ccik	cselekszenek/cselekednek	elhajlik
napozik	cvcik	cselekszenek/cselekednek	napozik
kallódik	cvcik	cselekszenek/cselekednek	kallódik
©őződik	cvcik	cselekszenek/cselekednek	győződik
vágódik	cvcik	cselekszenek/cselekednek	vágódik
bűnhődik	cvcik	cselekszenek/cselekednek	bűnhődik
sakkozik	cvcik	cselekszenek/cselekednek	sakkozik
alkudozik	cvcik	cselekszenek/cselekednek	alkudozik
idősödik	cvcik	cselekszenek/cselekednek	idősödik
hintázik	cvcik	cselekszenek/cselekednek	hintázik
ébredezik	cvcik	cselekszenek/cselekednek	ébredezik
torlódik	cvcik	cselekszenek/cselekednek	torlódik
furikázik	cvcik	cselekszenek/cselekednek	furikázik
háborúzik	cvcik	cselekszenek/cselekednek	háborúzik
paráΩlik	ccik	cselekszenek/cselekednek	parázslik
parádézik	cvcik	cselekszenek/cselekednek	parádézik
fúródik	cvcik	cselekszenek/cselekednek	fúródik
avasodik	cvcik	cselekszenek/cselekednek	avasodik
haláßik	cvcik	cselekszenek/cselekednek	halászik
vajúdik	cvcik	cselekszenek/cselekednek	vajúdik
döglődik	cvcik	cselekszenek/cselekednek	döglődik
fehéredik	cvcik	cselekszenek/cselekednek	fehéredik
kiérződik	cvcik	cselekszenek/cselekednek	kiérződik
¥elődik	cvcik	cselekszenek/cselekednek	nyelődik
e¥éßik	cvcik	cselekszenek/cselekednek	enyészik
sí¥lődik	cvcik	cselekszenek/cselekednek	sínylődik
táborozik	cvcik	cselekszenek/cselekednek	táborozik
erősködik	cvcik	cselekszenek/cselekednek	erősködik
háborodik	cvcik	cselekszenek/cselekednek	háborodik
férkőzik	cvcik	cselekszenek/cselekednek	férkőzik
vakarózik	cvcik	cselekszenek/cselekednek	vakarózik
vizesedik	cvcik	cselekszenek/cselekednek	vizesedik
bíbelődik	cvcik	cselekszenek/cselekednek	bíbelődik
örvé¥lik	ccik	cselekszenek/cselekednek	örvénylik
bénázik	cvcik	cselekszenek/cselekednek	bénázik
piroslik	ccik	cselekszenek/cselekednek	piroslik
porlik	ccik	cselekszenek/cselekednek	porlik
merevedik	cvcik	cselekszenek/cselekednek	merevedik
falatozik	cvcik	cselekszenek/cselekednek	falatozik
kamuzik	cvcik	cselekszenek/cselekednek	kamuzik
kár†ázik	cvcik	cselekszenek/cselekednek	kártyázik
túlórázik	cvcik	cselekszenek/cselekednek	túlórázik
parázik	cvcik	cselekszenek/cselekednek	parázik
pirosodik	cvcik	cselekszenek/cselekednek	pirosodik
óvakodik	cvcik	cselekszenek/cselekednek	óvakodik
párásodik	cvcik	cselekszenek/cselekednek	párásodik
ölelkezik	cvcik	cselekszenek/cselekednek	ölelkezik
ivódik	cvcik	cselekszenek/cselekednek	ivódik
omladozik	cvcik	cselekszenek/cselekednek	omladozik
állítódik	cvcik	cselekszenek/cselekednek	állítódik
cikkezik	cvcik	cselekszenek/cselekednek	cikkezik
éleződik	cvcik	cselekszenek/cselekednek	éleződik
vágtázik	cvcik	cselekszenek/cselekednek	vágtázik
poénkodik	cvcik	cselekszenek/cselekednek	poénkodik
tévézik	cvcik	cselekszenek/cselekednek	tévézik
okosodik	cvcik	cselekszenek/cselekednek	okosodik
morajlik	ccik	cselekszenek/cselekednek	morajlik
çajozik	cvcik	cselekszenek/cselekednek	csajozik
hozakodik	cvcik	cselekszenek/cselekednek	hozakodik
takarózik	cvcik	cselekszenek/cselekednek	takarózik
edződik	cvcik	cselekszenek/cselekednek	edződik
kapálózik	cvcik	cselekszenek/cselekednek	kapálózik
Ωidózik	cvcik	cselekszenek/cselekednek	zsidózik
dudorodik	cvcik	cselekszenek/cselekednek	dudorodik
lázadozik	cvcik	cselekszenek/cselekednek	lázadozik
vedlik	ccik	cselekszenek/cselekednek	vedlik
esedezik	cvcik	cselekszenek/cselekednek	esedezik
tömörödik	cvcik	cselekszenek/cselekednek	tömörödik
sörözik	cvcik	cselekszenek/cselekednek	sörözik
bringázik	cvcik	cselekszenek/cselekednek	bringázik
tanakodik	cvcik	cselekszenek/cselekednek	tanakodik
tépelődik	cvcik	cselekszenek/cselekednek	tépelődik
feketedik	cvcik	cselekszenek/cselekednek	feketedik
élcelődik	cvcik	cselekszenek/cselekednek	élcelődik
epekedik	cvcik	cselekszenek/cselekednek	epekedik
balhézik	cvcik	cselekszenek/cselekednek	balhézik
laposodik	cvcik	cselekszenek/cselekednek	laposodik
lehajlik	ccik	cselekszenek/cselekednek	lehajlik
átsejlik	ccik	cselekszenek/cselekednek	átsejlik
fingik	ccik	cselekszenek/cselekednek	fingik
kosarazik	cvcik	cselekszenek/cselekednek	kosarazik
pótlódik	cvcik	cselekszenek/cselekednek	pótlódik
biçaklik	ccik	cselekszenek/cselekednek	bicsaklik
©űrűzik	cvcik	cselekszenek/cselekednek	gyűrűzik
vonatozik	cvcik	cselekszenek/cselekednek	vonatozik
vésődik	cvcik	cselekszenek/cselekednek	vésődik
há¥ódik	cvcik	cselekszenek/cselekednek	hányódik
párosodik	cvcik	cselekszenek/cselekednek	párosodik
hívódik	cvcik	cselekszenek/cselekednek	hívódik
súrlódik	cvcik	cselekszenek/cselekednek	súrlódik
fosik	cvcik	cselekszenek/cselekednek	fosik
cumizik	cvcik	cselekszenek/cselekednek	cumizik
rakodik	cvcik	cselekszenek/cselekednek	rakodik
halódik	cvcik	cselekszenek/cselekednek	halódik
vörösödik	cvcik	cselekszenek/cselekednek	vörösödik
ßólózik	cvcik	cselekszenek/cselekednek	szólózik
ordítozik	cvcik	cselekszenek/cselekednek	ordítozik
repedezik	cvcik	cselekszenek/cselekednek	repedezik
sokasodik	cvcik	cselekszenek/cselekednek	sokasodik
veßődik	cvcik	cselekszenek/cselekednek	vesződik
nevelődik	cvcik	cselekszenek/cselekednek	nevelődik
villózik	cvcik	cselekszenek/cselekednek	villózik
a¥ázik	cvcik	cselekszenek/cselekednek	anyázik
kiáltozik	cvcik	cselekszenek/cselekednek	kiáltozik
bagózik	cvcik	cselekszenek/cselekednek	bagózik
babázik	cvcik	cselekszenek/cselekednek	babázik
ütődik	cvcik	cselekszenek/cselekednek	ütődik
büdösödik	cvcik	cselekszenek/cselekednek	büdösödik
ásítozik	cvcik	cselekszenek/cselekednek	ásítozik
másolódik	cvcik	cselekszenek/cselekednek	másolódik
olvadozik	cvcik	cselekszenek/cselekednek	olvadozik
behajlik	ccik	cselekszenek/cselekednek	behajlik
bujdosik	cvcik	cselekszenek/cselekednek	bujdosik
húzódozik	cvcik	cselekszenek/cselekednek	húzódozik
labdázik	cvcik	cselekszenek/cselekednek	labdázik
töredezik	cvcik	cselekszenek/cselekednek	töredezik
pipázik	cvcik	cselekszenek/cselekednek	pipázik
ü©esedik	cvcik	cselekszenek/cselekednek	ügyesedik
fürdőzik	cvcik	cselekszenek/cselekednek	fürdőzik
fújódik	cvcik	cselekszenek/cselekednek	fújódik
zúgolódik	cvcik	cselekszenek/cselekednek	zúgolódik
keseredik	cvcik	cselekszenek/cselekednek	keseredik
lökődik	cvcik	cselekszenek/cselekednek	lökődik
pattogzik	ccik	cselekszenek/cselekednek	pattogzik
izmosodik	cvcik	cselekszenek/cselekednek	izmosodik
leáldozik	cvcik	cselekszenek/cselekednek	leáldozik
átkozódik	cvcik	cselekszenek/cselekednek	átkozódik
futamodik	cvcik	cselekszenek/cselekednek	futamodik
bőgőzik	cvcik	cselekszenek/cselekednek	bőgőzik
kerekezik	cvcik	cselekszenek/cselekednek	kerekezik
borsózik	cvcik	cselekszenek/cselekednek	borsózik
gátlódik	cvcik	cselekszenek/cselekednek	gátlódik
zavarodik	cvcik	cselekszenek/cselekednek	zavarodik
¥űglődik	cvcik	cselekszenek/cselekednek	nyűglődik
mosdik	ccik	cselekszenek/cselekednek	mosdik
iramodik	cvcik	cselekszenek/cselekednek	iramodik
haknizik	cvcik	cselekszenek/cselekednek	haknizik
golfozik	cvcik	cselekszenek/cselekednek	golfozik
sötétlik	ccik	cselekszenek/cselekednek	sötétlik
©ülemlik	ccik	cselekszenek/cselekednek	gyülemlik
Ωűrizik	cvcik	cselekszenek/cselekednek	zsűrizik
üresedik	cvcik	cselekszenek/cselekednek	üresedik
kavarodik	cvcik	cselekszenek/cselekednek	kavarodik
lopózik	cvcik	cselekszenek/cselekednek	lopózik
gurigázik	cvcik	cselekszenek/cselekednek	gurigázik
púposodik	cvcik	cselekszenek/cselekednek	púposodik
bu¥ózik	cvcik	cselekszenek/cselekednek	bunyózik
öregedik	cvcik	cselekszenek/cselekednek	öregedik
fékeződik	cvcik	cselekszenek/cselekednek	fékeződik
áskálódik	cvcik	cselekszenek/cselekednek	áskálódik
ßarozik	cvcik	cselekszenek/cselekednek	szarozik
kárhozik	cvcik	cselekszenek/cselekednek	kárhozik
misézik	cvcik	cselekszenek/cselekednek	misézik
sikítozik	cvcik	cselekszenek/cselekednek	sikítozik
ßtorizik	cvcik	cselekszenek/cselekednek	sztorizik
sorjázik	cvcik	cselekszenek/cselekednek	sorjázik
éledezik	cvcik	cselekszenek/cselekednek	éledezik
por†ázik	cvcik	cselekszenek/cselekednek	portyázik
hahotázik	cvcik	cselekszenek/cselekednek	hahotázik
tusakodik	cvcik	cselekszenek/cselekednek	tusakodik
rögződik	cvcik	cselekszenek/cselekednek	rögződik
ßörfözik	cvcik	cselekszenek/cselekednek	szörfözik
tipródik	cvcik	cselekszenek/cselekednek	tipródik
mókázik	cvcik	cselekszenek/cselekednek	mókázik
hu©ozik	cvcik	cselekszenek/cselekednek	hugyozik
adósodik	cvcik	cselekszenek/cselekednek	adósodik
fölsejlik	ccik	cselekszenek/cselekednek	fölsejlik
fo©ózik	cvcik	cselekszenek/cselekednek	fogyózik
halálozik	cvcik	cselekszenek/cselekednek	halálozik
bimbózik	cvcik	cselekszenek/cselekednek	bimbózik
pecázik	cvcik	cselekszenek/cselekednek	pecázik
legózik	cvcik	cselekszenek/cselekednek	legózik
gürizik	cvcik	cselekszenek/cselekednek	gürizik
kétkedik	cvcik	cselekszenek/cselekednek	kétkedik
aßalódik	cvcik	cselekszenek/cselekednek	aszalódik
bußozik	cvcik	cselekszenek/cselekednek	buszozik
korosodik	cvcik	cselekszenek/cselekednek	korosodik
mélázik	cvcik	cselekszenek/cselekednek	mélázik
fuvolázik	cvcik	cselekszenek/cselekednek	fuvolázik
elmélázik	cvcik	cselekszenek/cselekednek	elmélázik
bá¥áßik	cvcik	cselekszenek/cselekednek	bányászik
parolázik	cvcik	cselekszenek/cselekednek	parolázik
tömődik	cvcik	cselekszenek/cselekednek	tömődik
pácolódik	cvcik	cselekszenek/cselekednek	pácolódik
kontrázik	cvcik	cselekszenek/cselekednek	kontrázik
karatézik	cvcik	cselekszenek/cselekednek	karatézik
cicizik	cvcik	cselekszenek/cselekednek	cicizik
levegőzik	cvcik	cselekszenek/cselekednek	levegőzik
záporozik	cvcik	cselekszenek/cselekednek	záporozik
vásik	cvcik	cselekszenek/cselekednek	vásik
kajakozik	cvcik	cselekszenek/cselekednek	kajakozik
packázik	cvcik	cselekszenek/cselekednek	packázik
vetítődik	cvcik	cselekszenek/cselekednek	vetítődik
takarodik	cvcik	cselekszenek/cselekednek	takarodik
tegeződik	cvcik	cselekszenek/cselekednek	tegeződik
oçúdik	cvcik	cselekszenek/cselekednek	ocsúdik
marakodik	cvcik	cselekszenek/cselekednek	marakodik
ámuldozik	cvcik	cselekszenek/cselekednek	ámuldozik
intéződik	cvcik	cselekszenek/cselekednek	intéződik
divatozik	cvcik	cselekszenek/cselekednek	divatozik
álmosodik	cvcik	cselekszenek/cselekednek	álmosodik
hallßik	ccik	cselekszenek/cselekednek	hallszik
évődik	cvcik	cselekszenek/cselekednek	évődik
pukizik	cvcik	cselekszenek/cselekednek	pukizik
hegesedik	cvcik	cselekszenek/cselekednek	hegesedik
kaçázik	cvcik	cselekszenek/cselekednek	kacsázik
rü©ezik	cvcik	cselekszenek/cselekednek	rügyezik
bakizik	cvcik	cselekszenek/cselekednek	bakizik
ßánkázik	cvcik	cselekszenek/cselekednek	szánkázik
pókerezik	cvcik	cselekszenek/cselekednek	pókerezik
lottózik	cvcik	cselekszenek/cselekednek	lottózik
ro©ik	cvcik	cselekszenek/cselekednek	rogyik
kuporodik	cvcik	cselekszenek/cselekednek	kuporodik
vöröslik	ccik	cselekszenek/cselekednek	vöröslik
rázódik	cvcik	cselekszenek/cselekednek	rázódik
ßaunázik	cvcik	cselekszenek/cselekednek	szaunázik
çellózik	cvcik	cselekszenek/cselekednek	csellózik
ivarzik	ccik	cselekszenek/cselekednek	ivarzik
fúvódik	cvcik	cselekszenek/cselekednek	fúvódik
hűvösödik	cvcik	cselekszenek/cselekednek	hűvösödik
mulatozik	cvcik	cselekszenek/cselekednek	mulatozik
bőrösödik	cvcik	cselekszenek/cselekednek	bőrösödik
jegesedik	cvcik	cselekszenek/cselekednek	jegesedik
zúzódik	cvcik	cselekszenek/cselekednek	zúzódik
kihajlik	ccik	cselekszenek/cselekednek	kihajlik
honosodik	cvcik	cselekszenek/cselekednek	honosodik
alázkodik	cvcik	cselekszenek/cselekednek	alázkodik
okádik	cvcik	cselekszenek/cselekednek	okádik
üzérkedik	cvcik	cselekszenek/cselekednek	üzérkedik
pedálozik	cvcik	cselekszenek/cselekednek	pedálozik
hatódik	cvcik	cselekszenek/cselekednek	hatódik
alibizik	cvcik	cselekszenek/cselekednek	alibizik
tempózik	cvcik	cselekszenek/cselekednek	tempózik
hősködik	cvcik	cselekszenek/cselekednek	hősködik
e©edik	cvcik	cselekszenek/cselekednek	egyedik
gá¬ázik	cvcik	cselekszenek/cselekednek	gályázik
lármázik	cvcik	cselekszenek/cselekednek	lármázik
cicázik	cvcik	cselekszenek/cselekednek	cicázik
nótázik	cvcik	cselekszenek/cselekednek	nótázik
büfizik	cvcik	cselekszenek/cselekednek	büfizik
malmozik	cvcik	cselekszenek/cselekednek	malmozik
ßabódik	cvcik	cselekszenek/cselekednek	szabódik
hajókázik	cvcik	cselekszenek/cselekednek	hajókázik
művelődik	cvcik	cselekszenek/cselekednek	művelődik
puskázik	cvcik	cselekszenek/cselekednek	puskázik
há¥kódik	cvcik	cselekszenek/cselekednek	hánykódik
ráhajlik	ccik	cselekszenek/cselekednek	ráhajlik
hajrázik	cvcik	cselekszenek/cselekednek	hajrázik
homokozik	cvcik	cselekszenek/cselekednek	homokozik
kockázik	cvcik	cselekszenek/cselekednek	kockázik
józanodik	cvcik	cselekszenek/cselekednek	józanodik
jojózik	cvcik	cselekszenek/cselekednek	jojózik
itatódik	cvcik	cselekszenek/cselekednek	itatódik
citerázik	cvcik	cselekszenek/cselekednek	citerázik
ejtőzik	cvcik	cselekszenek/cselekednek	ejtőzik
sebesedik	cvcik	cselekszenek/cselekednek	sebesedik
íratik	cvcik	cselekszenek/cselekednek	íratik
sápítozik	cvcik	cselekszenek/cselekednek	sápítozik
mu†izik	cvcik	cselekszenek/cselekednek	mutyizik
ßánkózik	cvcik	cselekszenek/cselekednek	szánkózik
cicózik	cvcik	cselekszenek/cselekednek	cicózik
hokizik	cvcik	cselekszenek/cselekednek	hokizik
karikázik	cvcik	cselekszenek/cselekednek	karikázik
repetázik	cvcik	cselekszenek/cselekednek	repetázik
fenekedik	cvcik	cselekszenek/cselekednek	fenekedik
©ónik	cvcik	cselekszenek/cselekednek	gyónik
bicajozik	cvcik	cselekszenek/cselekednek	bicajozik
lelkizik	cvcik	cselekszenek/cselekednek	lelkizik
autókázik	cvcik	cselekszenek/cselekednek	autókázik
¥itódik	cvcik	cselekszenek/cselekednek	nyitódik
visítozik	cvcik	cselekszenek/cselekednek	visítozik
fa©izik	cvcik	cselekszenek/cselekednek	fagyizik
bra†izik	cvcik	cselekszenek/cselekednek	bratyizik
ßaltózik	cvcik	cselekszenek/cselekednek	szaltózik
kókadozik	cvcik	cselekszenek/cselekednek	kókadozik
bűnözik	cvcik	cselekszenek/cselekednek	bűnözik
¥aklik	ccik	cselekszenek/cselekednek	nyaklik
esküdözik	cvcik	cselekszenek/cselekednek	esküdözik
kucorodik	cvcik	cselekszenek/cselekednek	kucorodik
festődik	cvcik	cselekszenek/cselekednek	festődik
sátorozik	cvcik	cselekszenek/cselekednek	sátorozik
civakodik	cvcik	cselekszenek/cselekednek	civakodik
trillázik	cvcik	cselekszenek/cselekednek	trillázik
utálkozik	cvcik	cselekszenek/cselekednek	utálkozik
tudódik	cvcik	cselekszenek/cselekednek	tudódik
sú¬zózik	cvcik	cselekszenek/cselekednek	súlyzózik
korzózik	cvcik	cselekszenek/cselekednek	korzózik
ripakodik	cvcik	cselekszenek/cselekednek	ripakodik
habarodik	cvcik	cselekszenek/cselekednek	habarodik
italozik	cvcik	cselekszenek/cselekednek	italozik
ájuldozik	cvcik	cselekszenek/cselekednek	ájuldozik
ökörködik	cvcik	cselekszenek/cselekednek	ökörködik
ßívózik	cvcik	cselekszenek/cselekednek	szívózik
tőΩdézik	cvcik	cselekszenek/cselekednek	tőzsdézik
bokázik	cvcik	cselekszenek/cselekednek	bokázik
kondizik	cvcik	cselekszenek/cselekednek	kondizik
mozizik	cvcik	cselekszenek/cselekednek	mozizik
borozik	cvcik	cselekszenek/cselekednek	borozik
hárfázik	cvcik	cselekszenek/cselekednek	hárfázik
hüledezik	cvcik	cselekszenek/cselekednek	hüledezik
heveredik	cvcik	cselekszenek/cselekednek	heveredik
bántódik	cvcik	cselekszenek/cselekednek	bántódik
cipekedik	cvcik	cselekszenek/cselekednek	cipekedik
ßüremlik	ccik	cselekszenek/cselekednek	szüremlik
pólózik	cvcik	cselekszenek/cselekednek	pólózik
jelölődik	cvcik	cselekszenek/cselekednek	jelölődik
koçmázik	cvcik	cselekszenek/cselekednek	kocsmázik
erősbödik	cvcik	cselekszenek/cselekednek	erősbödik
fogamzik	ccik	cselekszenek/cselekednek	fogamzik
tornáßik	cvcik	cselekszenek/cselekednek	tornászik
filmezik	cvcik	cselekszenek/cselekednek	filmezik
©ürkőzik	cvcik	cselekszenek/cselekednek	gyürkőzik
ßúródik	cvcik	cselekszenek/cselekednek	szúródik
deresedik	cvcik	cselekszenek/cselekednek	deresedik
kócolódik	cvcik	cselekszenek/cselekednek	kócolódik
nőzik	cvcik	cselekszenek/cselekednek	nőzik
pitizik	cvcik	cselekszenek/cselekednek	pitizik
dulakodik	cvcik	cselekszenek/cselekednek	dulakodik
töpörödik	cvcik	cselekszenek/cselekednek	töpörödik
egeréßik	cvcik	cselekszenek/cselekednek	egerészik
lakomázik	cvcik	cselekszenek/cselekednek	lakomázik
totojázik	cvcik	cselekszenek/cselekednek	totojázik
komorodik	cvcik	cselekszenek/cselekednek	komorodik
népesedik	cvcik	cselekszenek/cselekednek	népesedik
betlizik	cvcik	cselekszenek/cselekednek	betlizik
bátorodik	cvcik	cselekszenek/cselekednek	bátorodik
huzakodik	cvcik	cselekszenek/cselekednek	huzakodik
buçkázik	cvcik	cselekszenek/cselekednek	bucskázik
dekázik	cvcik	cselekszenek/cselekednek	dekázik
¥alizik	cvcik	cselekszenek/cselekednek	nyalizik
fogózik	cvcik	cselekszenek/cselekednek	fogózik
tangózik	cvcik	cselekszenek/cselekednek	tangózik
ku†ázik	cvcik	cselekszenek/cselekednek	kutyázik
peΩgőzik	cvcik	cselekszenek/cselekednek	pezsgőzik
pihizik	cvcik	cselekszenek/cselekednek	pihizik
ßolizik	cvcik	cselekszenek/cselekednek	szolizik
kamerázik	cvcik	cselekszenek/cselekednek	kamerázik
üzekedik	cvcik	cselekszenek/cselekednek	üzekedik
koçizik	cvcik	cselekszenek/cselekednek	kocsizik
rókázik	cvcik	cselekszenek/cselekednek	rókázik
tépődik	cvcik	cselekszenek/cselekednek	tépődik
lázasodik	cvcik	cselekszenek/cselekednek	lázasodik
robajlik	ccik	cselekszenek/cselekednek	robajlik
skálázik	cvcik	cselekszenek/cselekednek	skálázik
dagadozik	cvcik	cselekszenek/cselekednek	dagadozik
civódik	cvcik	cselekszenek/cselekednek	civódik
çetlik	ccik	cselekszenek/cselekednek	csetlik
bráçázik	cvcik	cselekszenek/cselekednek	brácsázik
őrizkedik	cvcik	cselekszenek/cselekednek	őrizkedik
magázódik	cvcik	cselekszenek/cselekednek	magázódik
gecizik	cvcik	cselekszenek/cselekednek	gecizik
ficamodik	cvcik	cselekszenek/cselekednek	ficamodik
harapózik	cvcik	cselekszenek/cselekednek	harapózik
betegedik	cvcik	cselekszenek/cselekednek	betegedik
düledezik	cvcik	cselekszenek/cselekednek	düledezik
petézik	cvcik	cselekszenek/cselekednek	petézik
ßobrozik	cvcik	cselekszenek/cselekednek	szobrozik
po†ázik	cvcik	cselekszenek/cselekednek	potyázik
dohosodik	cvcik	cselekszenek/cselekednek	dohosodik
dΩúdózik	cvcik	cselekszenek/cselekednek	dzsúdózik
gombáßik	cvcik	cselekszenek/cselekednek	gombászik
©ámkodik	cvcik	cselekszenek/cselekednek	gyámkodik
öblösödik	cvcik	cselekszenek/cselekednek	öblösödik
gazosodik	cvcik	cselekszenek/cselekednek	gazosodik
kotródik	cvcik	cselekszenek/cselekednek	kotródik
riadozik	cvcik	cselekszenek/cselekednek	riadozik
fusizik	cvcik	cselekszenek/cselekednek	fusizik
©úródik	cvcik	cselekszenek/cselekednek	gyúródik
çámpázik	cvcik	cselekszenek/cselekednek	csámpázik
piacozik	cvcik	cselekszenek/cselekednek	piacozik
ßundizik	cvcik	cselekszenek/cselekednek	szundizik
kásásodik	cvcik	cselekszenek/cselekednek	kásásodik
sipítozik	cvcik	cselekszenek/cselekednek	sipítozik
figurázik	cvcik	cselekszenek/cselekednek	figurázik
bálozik	cvcik	cselekszenek/cselekednek	bálozik
eléugrik	ccik	cselekszenek/cselekednek	eléugrik
majrézik	cvcik	cselekszenek/cselekednek	majrézik
korizik	cvcik	cselekszenek/cselekednek	korizik
kö¬kezik	cvcik	cselekszenek/cselekednek	kölykezik
hantázik	cvcik	cselekszenek/cselekednek	hantázik
kövesedik	cvcik	cselekszenek/cselekednek	kövesedik
riΩázik	cvcik	cselekszenek/cselekednek	rizsázik
cidrizik	cvcik	cselekszenek/cselekednek	cidrizik
ultizik	cvcik	cselekszenek/cselekednek	ultizik
édesedik	cvcik	cselekszenek/cselekednek	édesedik
panamázik	cvcik	cselekszenek/cselekednek	panamázik
adomázik	cvcik	cselekszenek/cselekednek	adomázik
aljasodik	cvcik	cselekszenek/cselekednek	aljasodik
vigadozik	cvcik	cselekszenek/cselekednek	vigadozik
çövezik	cvcik	cselekszenek/cselekednek	csövezik
maradozik	cvcik	cselekszenek/cselekednek	maradozik
narkózik	cvcik	cselekszenek/cselekednek	narkózik
rögbizik	cvcik	cselekszenek/cselekednek	rögbizik
borjazik	cvcik	cselekszenek/cselekednek	borjazik
epedezik	cvcik	cselekszenek/cselekednek	epedezik
hó¬agzik	ccik	cselekszenek/cselekednek	hólyagzik
dühödik	cvcik	cselekszenek/cselekednek	dühödik
kenuzik	cvcik	cselekszenek/cselekednek	kenuzik
redőződik	cvcik	cselekszenek/cselekednek	redőződik
hasadozik	cvcik	cselekszenek/cselekednek	hasadozik
páßtázik	cvcik	cselekszenek/cselekednek	pásztázik
lero©ik	cvcik	cselekszenek/cselekednek	lerogyik
rizikózik	cvcik	cselekszenek/cselekednek	rizikózik
sízik	cvcik	cselekszenek/cselekednek	sízik
bedilizik	cvcik	cselekszenek/cselekednek	bedilizik
go¬ózik	cvcik	cselekszenek/cselekednek	golyózik
kövéredik	cvcik	cselekszenek/cselekednek	kövéredik
dumçizik	cvcik	cselekszenek/cselekednek	dumcsizik
homá¬lik	ccik	cselekszenek/cselekednek	homálylik
bodorodik	cvcik	cselekszenek/cselekednek	bodorodik
nőiesedik	cvcik	cselekszenek/cselekednek	nőiesedik
bogozódik	cvcik	cselekszenek/cselekednek	bogozódik
gubózik	cvcik	cselekszenek/cselekednek	gubózik
inaskodik	cvcik	cselekszenek/cselekednek	inaskodik
zónázik	cvcik	cselekszenek/cselekednek	zónázik
kettőzik	cvcik	cselekszenek/cselekednek	kettőzik
hapcizik	cvcik	cselekszenek/cselekednek	hapcizik
tallózik	cvcik	cselekszenek/cselekednek	tallózik
tekerőzik	cvcik	cselekszenek/cselekednek	tekerőzik
óhajtozik	cvcik	cselekszenek/cselekednek	óhajtozik
ijedezik	cvcik	cselekszenek/cselekednek	ijedezik
ízesedik	cvcik	cselekszenek/cselekednek	ízesedik
rugódozik	cvcik	cselekszenek/cselekednek	rugódozik
feketézik	cvcik	cselekszenek/cselekednek	feketézik
hasasodik	cvcik	cselekszenek/cselekednek	hasasodik
kupálódik	cvcik	cselekszenek/cselekednek	kupálódik
varasodik	cvcik	cselekszenek/cselekednek	varasodik
a¥agozik	cvcik	cselekszenek/cselekednek	anyagozik
illetődik	cvcik	cselekszenek/cselekednek	illetődik
pendlizik	cvcik	cselekszenek/cselekednek	pendlizik
rákosodik	cvcik	cselekszenek/cselekednek	rákosodik
cihelődik	cvcik	cselekszenek/cselekednek	cihelődik
spurizik	cvcik	cselekszenek/cselekednek	spurizik
hidegedik	cvcik	cselekszenek/cselekednek	hidegedik
tökölődik	cvcik	cselekszenek/cselekednek	tökölődik
veßkődik	cvcik	cselekszenek/cselekednek	veszkődik
evődik	cvcik	cselekszenek/cselekednek	evődik
idegződik	cvcik	cselekszenek/cselekednek	idegződik
komázik	cvcik	cselekszenek/cselekednek	komázik
dáridózik	cvcik	cselekszenek/cselekednek	dáridózik
ga†ázik	cvcik	cselekszenek/cselekednek	gatyázik
javítódik	cvcik	cselekszenek/cselekednek	javítódik
próbázik	cvcik	cselekszenek/cselekednek	próbázik
sápadozik	cvcik	cselekszenek/cselekednek	sápadozik
fojtódik	cvcik	cselekszenek/cselekednek	fojtódik
légzik	ccik	cselekszenek/cselekednek	légzik
tüzesedik	cvcik	cselekszenek/cselekednek	tüzesedik
poharazik	cvcik	cselekszenek/cselekednek	poharazik
révedezik	cvcik	cselekszenek/cselekednek	révedezik
tudakozik	cvcik	cselekszenek/cselekednek	tudakozik
dominózik	cvcik	cselekszenek/cselekednek	dominózik
toßik	cvcik	cselekszenek/cselekednek	toszik
Ωugázik	cvcik	cselekszenek/cselekednek	zsugázik
gen¥ezik	cvcik	cselekszenek/cselekednek	gennyezik
¥álazik	cvcik	cselekszenek/cselekednek	nyálazik
tünedezik	cvcik	cselekszenek/cselekednek	tünedezik
arénázik	cvcik	cselekszenek/cselekednek	arénázik
éjjeledik	cvcik	cselekszenek/cselekednek	éjjeledik
andalodik	cvcik	cselekszenek/cselekednek	andalodik
bundázik	cvcik	cselekszenek/cselekednek	bundázik
raplizik	cvcik	cselekszenek/cselekednek	raplizik
tekézik	cvcik	cselekszenek/cselekednek	tekézik
uraskodik	cvcik	cselekszenek/cselekednek	uraskodik
aláhajlik	ccik	cselekszenek/cselekednek	aláhajlik
kettedik	cvcik	cselekszenek/cselekednek	kettedik
foßtódik	cvcik	cselekszenek/cselekednek	fosztódik
hallózik	cvcik	cselekszenek/cselekednek	hallózik
lúgozódik	cvcik	cselekszenek/cselekednek	lúgozódik
darálódik	cvcik	cselekszenek/cselekednek	darálódik
hurrázik	cvcik	cselekszenek/cselekednek	hurrázik
totózik	cvcik	cselekszenek/cselekednek	totózik
türemlik	ccik	cselekszenek/cselekednek	türemlik
húsosodik	cvcik	cselekszenek/cselekednek	húsosodik
jódlizik	cvcik	cselekszenek/cselekednek	jódlizik
vérengzik	ccik	cselekszenek/cselekednek	vérengzik
évelődik	cvcik	cselekszenek/cselekednek	évelődik
sározódik	cvcik	cselekszenek/cselekednek	sározódik
öregbedik	cvcik	cselekszenek/cselekednek	öregbedik
bero©ik	cvcik	cselekszenek/cselekednek	berogyik
ku¥izik	cvcik	cselekszenek/cselekednek	kunyizik
tokozódik	cvcik	cselekszenek/cselekednek	tokozódik
vidámodik	cvcik	cselekszenek/cselekednek	vidámodik
bumlizik	cvcik	cselekszenek/cselekednek	bumlizik
ßólamlik	ccik	cselekszenek/cselekednek	szólamlik
tokosodik	cvcik	cselekszenek/cselekednek	tokosodik
gombázik	cvcik	cselekszenek/cselekednek	gombázik
tusázik	cvcik	cselekszenek/cselekednek	tusázik
lassúdik	cvcik	cselekszenek/cselekednek	lassúdik
smacizik	cvcik	cselekszenek/cselekednek	smacizik
újhodik	cvcik	cselekszenek/cselekednek	újhodik
çokizik	cvcik	cselekszenek/cselekednek	csokizik
fogódik	cvcik	cselekszenek/cselekednek	fogódik
kulizik	cvcik	cselekszenek/cselekednek	kulizik
simlizik	cvcik	cselekszenek/cselekednek	simlizik
áporodik	cvcik	cselekszenek/cselekednek	áporodik
çalizik	cvcik	cselekszenek/cselekednek	csalizik
dobálódik	cvcik	cselekszenek/cselekednek	dobálódik
hamizik	cvcik	cselekszenek/cselekednek	hamizik
hájasodik	cvcik	cselekszenek/cselekednek	hájasodik
púzik	cvcik	cselekszenek/cselekednek	púzik
danáßik	cvcik	cselekszenek/cselekednek	danászik
ka©lózik	cvcik	cselekszenek/cselekednek	kagylózik
odázódik	cvcik	cselekszenek/cselekednek	odázódik
őnekik	cvcik	cselekszenek/cselekednek	őnekik
çigázik	cvcik	cselekszenek/cselekednek	csigázik
morΩázik	cvcik	cselekszenek/cselekednek	morzsázik
tanúzik	cvcik	cselekszenek/cselekednek	tanúzik
turházik	cvcik	cselekszenek/cselekednek	turházik
ittasodik	cvcik	cselekszenek/cselekednek	ittasodik
morzézik	cvcik	cselekszenek/cselekednek	morzézik
kuglizik	cvcik	cselekszenek/cselekednek	kuglizik
ßipózik	cvcik	cselekszenek/cselekednek	szipózik
fókázik	cvcik	cselekszenek/cselekednek	fókázik
hűtőzik	cvcik	cselekszenek/cselekednek	hűtőzik
rugódik	cvcik	cselekszenek/cselekednek	rugódik
römizik	cvcik	cselekszenek/cselekednek	römizik
blablázik	cvcik	cselekszenek/cselekednek	blablázik
cangázik	cvcik	cselekszenek/cselekednek	cangázik
hamukázik	cvcik	cselekszenek/cselekednek	hamukázik
dilizik	cvcik	cselekszenek/cselekednek	dilizik
hámozódik	cvcik	cselekszenek/cselekednek	hámozódik
ifjodik	cvcik	cselekszenek/cselekednek	ifjodik
buktázik	cvcik	cselekszenek/cselekednek	buktázik
cuclizik	cvcik	cselekszenek/cselekednek	cuclizik
©őzködik	cvcik	cselekszenek/cselekednek	győzködik
kitűrődik	cvcik	cselekszenek/cselekednek	kitűrődik
odvasodik	cvcik	cselekszenek/cselekednek	odvasodik
édeskedik	cvcik	cselekszenek/cselekednek	édeskedik
éme¬edik	cvcik	cselekszenek/cselekednek	émelyedik
aßpik	ccik	cselekszenek/cselekednek	aszpik
flótázik	cvcik	cselekszenek/cselekednek	flótázik
kenekedik	cvcik	cselekszenek/cselekednek	kenekedik
¥úzódik	cvcik	cselekszenek/cselekednek	nyúzódik
hajháßik	cvcik	cselekszenek/cselekednek	hajhászik
mailezik	cvcik	cselekszenek/cselekednek	mailezik
pikulázik	cvcik	cselekszenek/cselekednek	pikulázik
túrosodik	cvcik	cselekszenek/cselekednek	túrosodik
ömledezik	cvcik	cselekszenek/cselekednek	ömledezik
dámázik	cvcik	cselekszenek/cselekednek	dámázik
kúrázik	cvcik	cselekszenek/cselekednek	kúrázik
ßülemlik	ccik	cselekszenek/cselekednek	szülemlik
öklelőzik	cvcik	cselekszenek/cselekednek	öklelőzik
bukdosik	cvcik	cselekszenek/cselekednek	bukdosik
epéskedik	cvcik	cselekszenek/cselekednek	epéskedik
lóbálózik	cvcik	cselekszenek/cselekednek	lóbálózik
¥uláßik	cvcik	cselekszenek/cselekednek	nyulászik
nőßik	cvcik	cselekszenek/cselekednek	nőszik
snóblizik	cvcik	cselekszenek/cselekednek	snóblizik
sokadozik	cvcik	cselekszenek/cselekednek	sokadozik
tintázik	cvcik	cselekszenek/cselekednek	tintázik
toro¥lik	ccik	cselekszenek/cselekednek	toronylik
vénhedik	cvcik	cselekszenek/cselekednek	vénhedik
feslődik	cvcik	cselekszenek/cselekednek	feslődik
fölösödik	cvcik	cselekszenek/cselekednek	fölösödik
lasßózik	cvcik	cselekszenek/cselekednek	lasszózik
ple†ózik	cvcik	cselekszenek/cselekednek	pletyózik
telçizik	cvcik	cselekszenek/cselekednek	telcsizik
ölődik	cvcik	cselekszenek/cselekednek	ölődik
çikózik	cvcik	cselekszenek/cselekednek	csikózik
çőrözik	cvcik	cselekszenek/cselekednek	csőrözik
darázik	cvcik	cselekszenek/cselekednek	darázik
ebédezik	cvcik	cselekszenek/cselekednek	ebédezik
e©kézik	cvcik	cselekszenek/cselekednek	egykézik
jachtozik	cvcik	cselekszenek/cselekednek	jachtozik
lírázik	cvcik	cselekszenek/cselekednek	lírázik
murizik	cvcik	cselekszenek/cselekednek	murizik
valutázik	cvcik	cselekszenek/cselekednek	valutázik
vasutazik	cvcik	cselekszenek/cselekednek	vasutazik
ba†uzik	cvcik	cselekszenek/cselekednek	batyuzik
çurizik	cvcik	cselekszenek/cselekednek	csurizik
çökik	cvcik	cselekszenek/cselekednek	csökik
gombozik	cvcik	cselekszenek/cselekednek	gombozik
paklizik	cvcik	cselekszenek/cselekednek	paklizik
papizik	cvcik	cselekszenek/cselekednek	papizik
polkázik	cvcik	cselekszenek/cselekednek	polkázik
skubizik	cvcik	cselekszenek/cselekednek	skubizik
ágasodik	cvcik	cselekszenek/cselekednek	ágasodik
agaráßik	cvcik	cselekszenek/cselekednek	agarászik
bigézik	cvcik	cselekszenek/cselekednek	bigézik
fűtőzik	cvcik	cselekszenek/cselekednek	fűtőzik
germózik	cvcik	cselekszenek/cselekednek	germózik
híresedik	cvcik	cselekszenek/cselekednek	híresedik
likőrözik	cvcik	cselekszenek/cselekednek	likőrözik
tojózik	cvcik	cselekszenek/cselekednek	tojózik
biflázik	cvcik	cselekszenek/cselekednek	biflázik
©üremlik	ccik	cselekszenek/cselekednek	gyüremlik
hepajozik	cvcik	cselekszenek/cselekednek	hepajozik
igázik	cvcik	cselekszenek/cselekednek	igázik
kirugódik	cvcik	cselekszenek/cselekednek	kirugódik
kuksizik	cvcik	cselekszenek/cselekednek	kuksizik
¥űvődik	cvcik	cselekszenek/cselekednek	nyűvődik
revesedik	cvcik	cselekszenek/cselekednek	revesedik
rákáßik	cvcik	cselekszenek/cselekednek	rákászik
ródlizik	cvcik	cselekszenek/cselekednek	ródlizik
tokásodik	cvcik	cselekszenek/cselekednek	tokásodik
utálkodik	cvcik	cselekszenek/cselekednek	utálkodik
börzézik	cvcik	cselekszenek/cselekednek	börzézik
epréßik	cvcik	cselekszenek/cselekednek	eprészik
hajçizik	cvcik	cselekszenek/cselekednek	hajcsizik
korábbik	ccik	cselekszenek/cselekednek	korábbik
laßtizik	cvcik	cselekszenek/cselekednek	lasztizik
nénózik	cvcik	cselekszenek/cselekednek	nénózik
pe†hüdik	cvcik	cselekszenek/cselekednek	petyhüdik
rühelődik	cvcik	cselekszenek/cselekednek	rühelődik
rühesedik	cvcik	cselekszenek/cselekednek	rühesedik
silózik	cvcik	cselekszenek/cselekednek	silózik
tonik	cvcik	cselekszenek/cselekednek	tonik
aduzik	cvcik	cselekszenek/cselekednek	aduzik
çuklózik	cvcik	cselekszenek/cselekednek	csuklózik
çíkáßik	cvcik	cselekszenek/cselekednek	csíkászik
hatodik	cvcik	cselekszenek/cselekednek	hatodik
indigózik	cvcik	cselekszenek/cselekednek	indigózik
kallózik	cvcik	cselekszenek/cselekednek	kallózik
kövérßik	ccik	cselekszenek/cselekednek	kövérszik
lepkéßik	cvcik	cselekszenek/cselekednek	lepkészik
makizik	cvcik	cselekszenek/cselekednek	makizik
mindenik	cvcik	cselekszenek/cselekednek	mindenik
második	cvcik	cselekszenek/cselekednek	második
métázik	cvcik	cselekszenek/cselekednek	métázik
ne©edik	cvcik	cselekszenek/cselekednek	negyedik
nekik	cvcik	cselekszenek/cselekednek	nekik
palizik	cvcik	cselekszenek/cselekednek	palizik
pincézik	cvcik	cselekszenek/cselekednek	pincézik
pőçik	cvcik	cselekszenek/cselekednek	pőcsik
ri¥ázik	cvcik	cselekszenek/cselekednek	rinyázik
subázik	cvcik	cselekszenek/cselekednek	subázik
trémázik	cvcik	cselekszenek/cselekednek	trémázik
†úkáßik	cvcik	cselekszenek/cselekednek	tyúkászik
tóßtozik	cvcik	cselekszenek/cselekednek	tósztozik
valakik	cvcik	cselekszenek/cselekednek	valakik
vonalazik	cvcik	cselekszenek/cselekednek	vonalazik
